user_id,day,arrival_hour,charge_needed,min_duration,max_duration,deadline,price_willing,preferred_stations,utility_a,utility_b,preferred_time,user_type,earliest_slot,latest_slot,ideal_slot,time_utilities
0,9,21,17.026445149193748,3,11,24,0.07611218036850259,"[10, 13, 9]",96.57701954979275,3.048126474765959,21,night_charger,237,248,237,"{237: 96.57701954979275, 238: 93.52889307502679, 239: 84.38451365072892, 240: 69.14388127689912, 241: 47.80699595353741, 242: 20.37385768064378, 243: 0, 244: 0, 245: 0, 246: 0, 247: 0}"
0,3,20,36.7465005279211,4,10,24,0.13700192466330469,"[11, 8, 4]",75.81581676584783,1.1509892678697335,20,night_charger,92,102,92,"{92: 75.81581676584783, 93: 74.6648274979781, 94: 71.2118596943689, 95: 65.45691335502022, 96: 57.39998847993209, 97: 47.04108506910449, 98: 34.380203122537424, 99: 19.417342640230885, 100: 2.152503622184881, 101: 0}"
0,4,20,25.053988884671824,2,8,24,0.13700192466330469,"[13, 11, 10]",149.03744295788624,1.7686909328577958,20,night_charger,116,124,116,"{116: 149.03744295788624, 117: 147.26875202502845, 118: 141.96267922645507, 119: 133.11922456216607, 120: 120.73838803216151, 121: 104.82016963644135, 122: 85.3645693750056, 123: 62.37158724785425}"
1,13,10,49.0255759366112,3,6,16,0.15158464018535778,"[8, 9, 4]",140.88240309687967,1.0846894549415138,10,random,322,328,322,"{322: 140.88240309687967, 323: 139.79771364193815, 324: 136.54364527711363, 325: 131.12019800240606, 326: 123.52737181781545, 327: 113.76516672334182}"
1,11,21,74.92846842629379,6,8,24,0.17833487080630325,"[10, 7, 11]",72.70012993384206,1.885106364264736,21,random,285,293,285,"{285: 72.70012993384206, 286: 70.81502356957733, 287: 65.15970447678312, 288: 55.73417265545944, 289: 42.538428105606286, 290: 25.57247082722366, 291: 4.836300820311564, 292: 0}"
2,10,20,49.39088261454817,3,6,24,0.24413029076695206,"[9, 11, 3]",66.8141085894747,4.888383972849244,20,random,260,266,260,"{260: 66.8141085894747, 261: 61.92572461662546, 262: 47.26057269807772, 263: 22.818652833831507, 264: 0, 265: 0}"
3,7,12,14.93659932900819,2,6,18,0.11417100351708476,"[3, 7, 4]",66.76215638405844,2.051522807957304,12,work_charger,180,186,180,"{180: 66.76215638405844, 181: 64.71063357610115, 182: 58.55606515222922, 183: 48.298451112442706, 184: 33.93779145674158, 185: 15.474086185125842}"
3,2,13,23.246611823449815,2,6,19,0.11417100351708476,"[9, 3, 11]",141.59277461037811,4.832491181918452,13,work_charger,61,67,61,"{61: 141.59277461037811, 62: 136.76028342845967, 63: 122.2628098827043, 64: 98.10035397311205, 65: 64.27291569968288, 66: 20.78049506241682}"
3,11,10,19.255556885068426,2,7,17,0.11417100351708476,"[9, 5, 0]",51.4470641502865,1.4769143112714347,10,work_charger,274,281,274,"{274: 51.4470641502865, 275: 49.970149839015065, 276: 45.539406905200764, 277: 38.15483534884359, 278: 27.816435169943546, 279: 14.524206368500636, 280: 0}"
3,3,13,44.77007440493476,3,8,21,0.11417100351708476,"[4, 3, 13]",136.77820443927635,2.4805916734016678,13,work_charger,85,93,85,"{85: 136.77820443927635, 86: 134.29761276587467, 87: 126.85583774566967, 88: 114.45287937866134, 89: 97.08873766484967, 90: 74.76341260423466, 91: 47.47690419681631, 92: 15.22921244259463}"
4,11,8,73.8605488176303,6,8,16,0.1333293842015118,"[2, 6, 7]",98.99317532448607,3.1550903444604645,8,random,272,280,272,"{272: 98.99317532448607, 273: 95.83808498002561, 274: 86.37281394664421, 275: 70.5973622243419, 276: 48.51172981311864, 277: 20.115916712974467, 278: 0, 279: 0}"
4,11,12,54.47078160029769,6,7,19,0.08888625613434122,"[1, 6, 11]",132.80595427328763,2.6462550876041213,12,random,276,283,276,"{276: 132.80595427328763, 277: 130.1596991856835, 278: 122.22093392287114, 279: 108.98965848485054, 280: 90.46587287162168, 281: 66.6495770831846, 282: 37.54077111953926}"
5,10,14,34.70524973227224,3,7,21,0.11335658026724205,"[13, 7, 0]",72.74908908690624,2.902482457233036,14,random,254,261,254,"{254: 72.74908908690624, 255: 69.8466066296732, 256: 61.13915925797409, 257: 46.62674697180891, 258: 26.309369771177664, 259: 0.1870276560803461, 260: 0}"
5,13,21,24.862753327760462,2,5,24,0.09635309322715574,"[12, 7, 9]",122.75933433047433,3.717266661254214,21,random,333,338,333,"{333: 122.75933433047433, 334: 119.04206766922012, 335: 107.89026768545747}"
6,13,9,64.20844192566553,5,10,19,0.134744754632081,"[1, 0, 6]",68.76109885454247,1.0865916103489917,9,weekend_user,321,331,321,"{321: 68.76109885454247, 322: 67.67450724419348, 323: 64.4147324131465, 324: 58.98177436140154, 325: 51.3756330889586, 326: 41.596308595817675, 327: 29.64380088197877, 328: 15.518109947441879, 329: 0, 330: 0}"
7,3,8,15.752911547860364,1,2,10,0.2681059140626899,"[11, 3, 8]",67.20998526498622,2.221726770732129,8,commuter,80,82,80,"{80: 67.20998526498622, 81: 64.98825849425408}"
7,9,17,23.014120256388306,4,5,22,0.321727096875228,"[8, 13, 10]",139.7243325191642,4.563307014297074,17,commuter,233,238,233,"{233: 139.7243325191642, 234: 135.16102550486713, 235: 121.4711044619759, 236: 98.65456939049054, 237: 66.71142029041101}"
7,13,16,32.40311822935359,2,3,19,0.1519266846355243,"[5, 8, 1]",117.894542428067,3.9003840755906034,16,commuter,328,331,328,"{328: 117.894542428067, 329: 113.99415835247639, 330: 102.29300612570458}"
8,12,17,24.368756258798932,2,5,22,0.12963332579625003,"[9, 6, 5]",108.91334031560382,3.5906774244833035,17,commuter,305,310,305,"{305: 108.91334031560382, 306: 105.32266289112052, 307: 94.5506306176706, 308: 76.59724349525408, 309: 51.46250152387096}"
8,2,17,21.181792077705953,2,4,21,0.1525097950544118,"[6, 0, 5]",77.37099171728426,3.024145080909923,17,commuter,65,69,65,"{65: 77.37099171728426, 66: 74.34684663637434, 67: 65.27441139364456, 68: 50.153685989094946}"
8,10,9,29.396870471978772,5,7,16,0.1270914958786765,"[7, 13, 1]",118.15260298866504,3.720438793733109,9,commuter,249,256,249,"{249: 118.15260298866504, 250: 114.43216419493193, 251: 103.2708478137326, 252: 84.66865384506706, 253: 58.62558228893529, 254: 25.14163314533731, 255: 0}"
9,12,10,44.660423299729786,3,6,16,0.1115538442138608,"[14, 13, 0]",86.03211376915627,4.252573561197346,10,commuter,298,304,298,"{298: 86.03211376915627, 299: 81.77954020795892, 300: 69.02181952436689, 301: 47.75895171838015, 302: 17.990936789998727, 303: 0}"
9,10,8,46.54806084937037,7,10,18,0.19685972508328375,"[9, 12, 5]",93.04219080879669,2.638073921114856,8,commuter,248,258,248,"{248: 93.04219080879669, 249: 90.40411688768184, 250: 82.48989512433727, 251: 69.29952551876299, 252: 50.833008070958996, 253: 27.090342780925297, 254: 0, 255: 0, 256: 0, 257: 0}"
9,6,10,75.40933629938078,5,6,16,0.1115538442138608,"[1, 6, 2]",111.90930952711196,1.5747664290469356,10,commuter,154,160,154,"{154: 111.90930952711196, 155: 110.33454309806503, 156: 105.61024381092422, 157: 97.73641166568953, 158: 86.713046662361, 159: 72.54014880093857}"
10,5,19,58.71745582573021,5,10,24,0.3225854326915507,"[11, 8, 2]",75.09864855231814,3.953935888744423,19,weekend_user,139,149,139,"{139: 75.09864855231814, 140: 71.14471266357371, 141: 59.282904997340445, 142: 39.513225553618334, 143: 11.835674332407372, 144: 0, 145: 0, 146: 0, 147: 0, 148: 0}"
11,7,19,27.51937795781812,2,4,23,0.18044728409544317,"[11, 0, 1]",114.53195833376168,2.669548510802186,19,commuter,187,191,187,"{187: 114.53195833376168, 188: 111.86240982295949, 189: 103.85376429055293, 190: 90.50602173654201}"
11,1,7,38.67758611292691,2,4,11,0.1503727367462026,"[8, 1, 11]",92.27587770882381,4.202060498393934,7,commuter,31,35,31,"{31: 92.27587770882381, 32: 88.07381721042988, 33: 75.46763571524808, 34: 54.45733322327841}"
11,13,10,26.79149013384148,2,5,15,0.08521121748951482,"[0, 12, 4]",105.07432808910721,2.1603690598029917,10,commuter,322,327,322,"{322: 105.07432808910721, 323: 102.91395902930422, 324: 96.43285184989524, 325: 85.63100655088029, 326: 70.50842313225934}"
11,11,17,41.55507088991491,5,6,23,0.18044728409544317,"[3, 6, 5]",135.88139146748568,1.5061778348536325,17,commuter,281,287,281,"{281: 135.88139146748568, 282: 134.37521363263204, 283: 129.85668012807116, 284: 122.325790953803, 285: 111.78254610982756, 286: 98.22694559614487}"
11,13,18,43.99460018545236,5,7,24,0.15338019148112667,"[12, 14, 13]",72.71497467713269,1.0321274555024917,18,commuter,330,337,330,"{330: 72.71497467713269, 331: 71.6828472216302, 332: 68.58646485512273, 333: 63.425827577610264, 334: 56.20093538909282, 335: 46.911788289570396}"
12,1,19,39.37493792431663,3,5,24,0.3276159576936936,"[11, 3, 8]",55.75718653027971,4.109782513013645,19,commuter,43,48,43,"{43: 55.75718653027971, 44: 51.64740401726607, 45: 39.31805647822513, 46: 18.76914391315691, 47: 0}"
12,0,18,50.58408436245451,4,6,24,0.3276159576936936,"[4, 12, 2]",147.06000678574586,3.219726577497373,18,commuter,18,24,18,"{18: 147.06000678574586, 19: 143.8402802082485, 20: 134.18110047575635, 21: 118.0824675882695, 22: 95.54438154578789, 23: 66.56684234831152}"
12,11,9,43.70636143416222,5,8,17,0.273013298078078,"[11, 3, 13]",139.3443465376265,1.7766107864741962,9,commuter,273,281,273,"{273: 139.3443465376265, 274: 137.5677357511523, 275: 132.23790339172973, 276: 123.35484945935875, 277: 110.91857395403937, 278: 94.9290768757716, 279: 75.38635822455544, 280: 52.290418000390886}"
12,13,14,55.213621026153525,3,6,20,0.15470753557757755,"[13, 8, 9]",104.53628521336417,1.2048253967613163,14,commuter,326,332,326,"{326: 104.53628521336417, 327: 103.33145981660284, 328: 99.7169836263189, 329: 93.69285664251233, 330: 85.25907886518311, 331: 74.41565029433126}"
12,9,9,53.26632237432137,4,5,14,0.273013298078078,"[14, 9, 5]",114.50098154915673,2.5816200421188307,9,commuter,225,230,225,"{225: 114.50098154915673, 226: 111.9193615070379, 227: 104.1745013806814, 228: 91.26640117008725, 229: 73.19506087525545}"
13,6,15,78.7963548053716,8,11,24,0.19726344838987092,"[12, 9, 14]",57.24223128606848,2.1810425203438957,15,commuter,159,170,159,"{159: 57.24223128606848, 160: 55.06118876572459, 161: 48.5180612046929, 162: 37.61284860297342, 163: 22.34555096056615, 164: 2.716168277471091, 165: 0, 166: 0, 167: 0, 168: 0, 169: 0}"
13,3,18,44.85025431117588,3,6,24,0.4177343612961973,"[4, 7, 11]",70.52716745506585,2.1716229868069163,18,commuter,90,96,90,"{90: 70.52716745506585, 91: 68.35554446825893, 92: 61.840675507838185, 93: 50.9825605738036, 94: 35.78119966615519, 95: 16.23659278489294}"
13,12,13,34.870130490496386,2,5,18,0.19726344838987092,"[2, 12, 3]",58.292715250972606,3.567101617764045,13,commuter,301,306,301,"{301: 58.292715250972606, 302: 54.72561363320856, 303: 44.024308779916424, 304: 26.188800691096205, 305: 1.2190893667478875}"
13,10,18,25.395903638307402,2,5,23,0.4177343612961973,"[3, 12, 13]",112.34381336941121,2.374589233781594,18,commuter,258,263,258,"{258: 112.34381336941121, 259: 109.96922413562962, 260: 102.84545643428483, 261: 90.97251026537685, 262: 74.35038562890571}"
14,10,9,21.280181732418107,2,3,12,0.12548938331534393,"[0, 8, 4]",138.0548342338957,2.309001231623268,9,commuter,249,252,249,"{249: 138.0548342338957, 250: 135.74583300227243, 251: 128.8188293074026}"
14,9,8,32.83345382594405,4,7,15,0.12548938331534393,"[7, 14, 12]",66.1712778330108,2.4755300862235567,8,commuter,224,231,224,"{224: 66.1712778330108, 225: 63.69574774678725, 226: 56.269157488116576, 227: 43.89150705699879, 228: 26.562796453433897, 229: 4.2830256774218896, 230: 0}"
14,7,7,19.220577982041497,2,4,11,0.12548938331534393,"[9, 12, 2]",96.1770366396279,4.641385385234621,7,commuter,175,179,175,"{175: 96.1770366396279, 176: 91.53565125439329, 177: 77.61149509868942, 178: 54.40456817251631}"
14,5,12,7.918061574640593,1,4,16,0.07111065054536157,"[3, 6, 1]",110.65258670505337,1.4149206581699767,12,commuter,132,136,132,"{132: 110.65258670505337, 133: 109.23766604688339, 134: 104.99290407237346, 135: 97.91830078152358}"
15,11,17,34.57824165297535,4,7,24,0.22684435867586222,"[0, 3, 2]",111.21662207231456,1.6661823543752052,17,commuter,281,288,281,"{281: 111.21662207231456, 282: 109.55043971793935, 283: 104.55189265481374, 284: 96.22098088293771, 285: 84.55770440231129, 286: 69.56206321293443, 287: 51.234057314807174}"
15,1,18,53.24527069542522,6,8,24,0.22684435867586222,"[11, 4, 12]",93.17328238428492,2.8119924033198553,18,commuter,42,50,42,"{42: 93.17328238428492, 43: 90.36128998096507, 44: 81.9253127710055, 45: 67.86535075440622, 46: 48.18140393116723, 47: 22.87347230128853, 48: 0, 49: 0}"
15,6,14,42.676761903037345,3,6,20,0.10712094715249049,"[2, 9, 4]",94.24913136680374,3.5877868333492215,14,commuter,158,164,158,"{158: 94.24913136680374, 159: 90.66134453345451, 160: 79.89798403340686, 161: 61.95904986666074, 162: 36.84454203321619, 163: 4.554460533073197}"
15,0,17,32.373894159363545,2,5,22,0.22684435867586222,"[11, 12, 6]",91.27630727487937,4.05698248340952,17,commuter,17,22,17,"{17: 91.27630727487937, 18: 87.21932479146986, 19: 75.04837734124129, 20: 54.76346492419369, 21: 26.36458754032705}"
16,13,18,65.85299739487105,4,6,24,0.14132421114297333,"[0, 11, 14]",55.41344084023208,3.387427443137964,18,random,330,336,330,"{330: 55.41344084023208, 331: 52.02601339709411, 332: 41.86373106768022, 333: 24.926593851990404, 334: 1.2146017500246558, 335: 0}"
16,11,11,44.51285306227482,3,4,15,0.09236876545292375,"[12, 1, 3]",81.11206807596474,2.2827971401652913,11,random,275,279,275,"{275: 81.11206807596474, 276: 78.82927093579946, 277: 71.98087951530357, 278: 60.56689381447712}"
16,4,13,51.61011952278722,4,7,20,0.09236876545292375,"[2, 7, 6]",107.57193053312042,3.333544929310992,13,random,109,116,109,"{109: 107.57193053312042, 110: 104.23838560380943, 111: 94.23775081587645, 112: 77.5700261693215, 113: 54.23521166414455, 114: 24.23330730034563, 115: 0}"
17,3,18,77.06814355889473,8,11,24,0.28849811246776147,"[14, 3, 2]",73.10361379470595,1.1863197683461664,18,random,90,101,90,"{90: 73.10361379470595, 91: 71.91729402635978, 92: 68.35833472132128, 93: 62.42673587959045, 94: 54.12249750116729, 95: 43.44561958605179, 96: 30.39610213424396, 97: 14.973945145743798, 98: 0, 99: 0, 100: 0}"
17,8,10,37.016344024662345,2,5,15,0.16027672914875635,"[7, 6, 5]",84.34206161306739,2.8394043236017286,10,random,202,207,202,"{202: 84.34206161306739, 203: 81.50265728946566, 204: 72.98444431866048, 205: 58.78742270065183, 206: 38.91159243543973}"
17,1,14,38.96628645993326,3,7,21,0.16027672914875635,"[14, 3, 12]",90.9838478109594,4.9632054237837515,14,random,38,45,38,"{38: 90.9838478109594, 39: 86.02064238717566, 40: 71.1310261158244, 41: 46.31499899690564, 42: 11.57256103041938, 43: 0, 44: 0}"
18,1,7,30.962399565230797,3,4,11,0.13389229280364334,"[5, 3, 13]",98.18733839449902,3.252377111489971,7,commuter,31,35,31,"{31: 98.18733839449902, 32: 94.93496128300905, 33: 85.17782994853914, 34: 68.91594439108928}"
18,4,9,38.4409205296936,4,6,15,0.13389229280364334,"[9, 1, 7]",69.3700292785702,1.8335347160353015,9,commuter,105,111,105,"{105: 69.3700292785702, 106: 67.5364945625349, 107: 62.03589041442899, 108: 52.868216834252486, 109: 40.03347382200538, 110: 23.531661377687662}"
18,13,10,43.98733080916684,3,6,16,0.0758722992553979,"[14, 7, 0]",80.63445752021462,3.6647718410657246,10,commuter,322,328,322,"{322: 80.63445752021462, 323: 76.9696856791489, 324: 65.97537015595172, 325: 47.651510950623106, 326: 21.99810806316303, 327: 0}"
19,2,9,47.54497349946182,4,6,15,0.3368748156575088,"[2, 5, 4]",111.47709531562623,4.61110419105818,9,commuter,57,63,57,"{57: 111.47709531562623, 58: 106.86599112456805, 59: 93.0326785513935, 60: 69.97715759610261, 61: 37.69942825869535, 62: 0}"
19,6,19,37.68770468015969,4,6,24,0.343612311970659,"[7, 2, 8]",124.24575642135565,1.8795319588293964,19,commuter,163,169,163,"{163: 124.24575642135565, 164: 122.36622446252625, 165: 116.72762858603807, 166: 107.32996879189108, 167: 94.17324508008531, 168: 77.25745745062073}"
19,4,8,35.016393678512394,2,5,13,0.3368748156575088,"[8, 12, 7]",144.5117507342546,1.8578329172966463,8,commuter,104,109,104,"{104: 144.5117507342546, 105: 142.65391781695797, 106: 137.080419065068, 107: 127.79125447858479, 108: 114.78642405750827}"
19,1,17,36.80933221383237,2,4,21,0.40424977878901064,"[14, 5, 3]",139.4749220975798,2.986895304392713,17,commuter,41,45,41,"{41: 139.4749220975798, 42: 136.4880267931871, 43: 127.52734088000894, 44: 112.59286435804538}"
19,3,18,55.33869986855634,4,6,24,0.40424977878901064,"[9, 7, 5]",115.1489153529613,2.0361568404820587,18,commuter,90,96,90,"{90: 115.1489153529613, 91: 113.11275851247923, 92: 107.00428799103307, 93: 96.82350378862277, 94: 82.57040590524835, 95: 64.24499434090983}"
20,8,8,15.042870983178801,1,4,12,0.21760995279581025,"[11, 2, 4]",124.85647184536268,2.7484970949600496,8,commuter,200,204,200,"{200: 124.85647184536268, 201: 122.10797475040263, 202: 113.86248346552247, 203: 100.11999799072223}"
20,3,19,42.00548441740922,4,6,24,0.26113194335497236,"[13, 2, 6]",72.60991936266922,4.386887961586933,19,commuter,91,97,91,"{91: 72.60991936266922, 92: 68.22303140108228, 93: 55.06236751632149, 94: 33.127927708386814, 95: 2.4197119772782827, 96: 0}"
20,7,18,34.496329214608025,2,4,22,0.26113194335497236,"[12, 13, 2]",53.24601417622764,3.9782274284183172,18,commuter,186,190,186,"{186: 53.24601417622764, 187: 49.267786747809325, 188: 37.333104462554374, 189: 17.441967320462787}"
20,13,18,32.79745333844403,2,4,22,0.22196215185172646,"[8, 10, 3]",105.5018524205291,2.148850284509446,18,commuter,330,334,330,"{330: 105.5018524205291, 331: 103.35300213601965, 332: 96.90645128249132, 333: 86.16219985994408}"
21,1,17,40.40352781652644,4,6,23,0.13725839981993396,"[5, 3, 0]",74.23257302463215,3.7151039340817156,17,commuter,41,47,41,"{41: 74.23257302463215, 42: 70.51746909055043, 43: 59.37215728830528, 44: 40.79663761789671, 45: 14.790910079324696, 46: 0}"
21,0,17,56.01681030359556,5,8,24,0.13725839981993396,"[7, 2, 9]",86.41528191046055,4.409461397048174,17,commuter,17,25,17,"{17: 86.41528191046055, 18: 82.00582051341237, 19: 68.77743632226785, 20: 46.73012933702698, 21: 15.863899557689763, 22: 0, 23: 0, 24: 0}"
21,11,19,61.691969981438476,5,8,24,0.13725839981993396,"[7, 12, 2]",99.2078186535646,2.5757770587623385,19,commuter,283,291,283,"{283: 99.2078186535646, 284: 96.63204159480226, 285: 88.90471041851525, 286: 76.02582512470356, 287: 57.995385713367185, 288: 34.81339218450614, 289: 6.4798445381204175, 290: 0}"
21,10,18,6.703747885974245,1,4,22,0.13725839981993396,"[2, 8, 4]",122.26472020610684,2.285404400758885,18,commuter,258,262,258,"{258: 122.26472020610684, 259: 119.97931580534797, 260: 113.1231026030713, 261: 101.69608059927688}"
22,0,7,80.68710847346148,5,6,13,0.1330585762792124,"[3, 6, 0]",68.60340613712786,4.738147926564813,7,random,7,13,7,"{7: 68.60340613712786, 8: 63.86525821056305, 9: 49.65081443086861, 10: 25.960074798044545, 11: 0, 12: 0}"
23,7,23,34.55604759515848,3,8,24,0.08427751605234314,"[5, 7, 9]",97.24621139148906,3.7932532957622405,23,night_charger,191,199,191,"{191: 97.24621139148906, 192: 93.45295809572681, 193: 82.07319820844009, 194: 63.10693172962889, 195: 36.55415865929321, 196: 2.41487899743305, 197: 0, 198: 0}"
23,4,22,34.08318087187198,2,10,24,0.12039645150334734,"[0, 4, 11]",129.41627088376094,1.809870168383,22,night_charger,118,128,118,"{118: 129.41627088376094, 119: 127.60640071537794, 120: 122.17679021022894, 121: 113.12743936831394, 122: 100.45834818963294, 123: 84.16951667418594, 124: 64.26094482197294, 125: 40.73263263299394, 126: 13.58458010724894, 127: 0}"
24,1,7,71.46610597275921,8,10,17,0.22284592508264692,"[3, 14, 13]",100.90833066899516,2.7330029707830015,7,commuter,31,41,31,"{31: 100.90833066899516, 32: 98.17532769821216, 33: 89.97631878586316, 34: 76.31130393194815, 35: 57.18028313646714, 36: 32.58325639942012, 37: 2.5202237208071097, 38: 0, 39: 0, 40: 0}"
24,4,9,70.17543765861461,8,10,19,0.22284592508264692,"[7, 5, 11]",59.695139262671475,2.4048680785539522,9,commuter,105,115,105,"{105: 59.695139262671475, 106: 57.29027118411752, 107: 50.07566694845566, 108: 38.051326555685904, 109: 21.21725000580824, 110: 0, 111: 0, 112: 0, 113: 0, 114: 0}"
24,5,19,83.44800756393029,8,11,24,0.22730284358429986,"[6, 11, 8]",114.43657004925673,4.030039291274024,19,commuter,139,150,139,"{139: 114.43657004925673, 140: 110.40653075798271, 141: 98.31641288416063, 142: 78.16621642779052, 143: 49.95594138887235, 144: 13.685587767406133, 145: 0, 146: 0, 147: 0, 148: 0, 149: 0}"
24,2,9,71.41621542433283,5,8,17,0.22284592508264692,"[9, 1, 11]",122.2021143360029,3.66588078421482,9,commuter,57,65,57,"{57: 122.2021143360029, 58: 118.53623355178807, 59: 107.53859119914361, 60: 89.20918727806952, 61: 63.54802178856577, 62: 30.55509473063239, 63: 0, 64: 0}"
24,3,19,54.91951966280159,5,6,24,0.26741511009917635,"[13, 8, 3]",62.16228906800943,2.4535699177285064,19,commuter,91,97,91,"{91: 62.16228906800943, 92: 59.70871915028092, 93: 52.3480093970954, 94: 40.08015980845287, 95: 22.905170384353326, 96: 0.8230411247967666}"
25,1,20,85.99936811202436,5,6,24,0.14931947235418586,"[8, 12, 9]",97.52465265872004,4.4184302509334845,20,random,44,50,44,"{44: 97.52465265872004, 45: 93.10622240778656, 46: 79.85093165498611, 47: 57.758780400318685, 48: 26.82976864378429, 49: 0}"
26,9,7,38.48059963767836,2,4,11,0.17080759457825834,"[11, 7, 12]",60.44729858159362,2.797183283585018,7,commuter,223,227,223,"{223: 60.44729858159362, 224: 57.6501152980086, 225: 49.258565447253545, 226: 35.27264902932846}"
26,12,14,31.431823514443078,2,5,19,0.09679097026101308,"[8, 6, 1]",117.29178242869764,2.729789438420855,14,commuter,302,307,302,"{302: 117.29178242869764, 303: 114.56199299027679, 304: 106.37262467501422, 305: 92.72367748290995, 306: 73.61515141396396}"
26,8,19,30.974794766229774,3,5,24,0.20496911349391006,"[11, 14, 9]",123.95864896782489,1.9904755487956227,19,commuter,211,216,211,"{211: 123.95864896782489, 212: 121.96817341902926, 213: 115.9967467726424, 214: 106.04436902866428, 215: 92.11104018709491}"
27,11,10,60.65173820661343,8,12,22,0.0915953607223262,"[0, 5, 6]",90.51562070861648,1.8423167620197733,10,work_charger,274,286,274,"{274: 90.51562070861648, 275: 88.6733039465967, 276: 83.14635366053739, 277: 73.93476985043853, 278: 61.03855251630011, 279: 44.45770165812215, 280: 24.19221727590464, 281: 0.24209936964759038, 282: 0, 283: 0, 284: 0, 285: 0}"
27,2,11,48.65493247233792,5,7,18,0.0915953607223262,"[0, 11, 1]",133.44542148916963,2.4431536043149067,11,work_charger,59,66,59,"{59: 133.44542148916963, 60: 131.00226788485472, 61: 123.67280707191, 62: 111.45703905033547, 63: 94.35496382013113, 64: 72.36658138129697, 65: 45.491891733832986}"
27,11,8,55.858530780694394,5,8,16,0.1373930410834893,"[2, 1, 3]",101.43832465110202,3.355037854260038,8,work_charger,272,280,272,"{272: 101.43832465110202, 273: 98.08328679684199, 274: 88.01817323406186, 275: 71.24298396276168, 276: 47.75771898294141, 277: 17.562378294601075, 278: 0, 279: 0}"
28,3,22,10.688477785701256,2,9,24,0.09195901087489411,"[5, 12, 3]",50.572093154196466,3.605279588904957,22,night_charger,94,103,94,"{94: 50.572093154196466, 95: 46.96681356529151, 96: 36.15097479857664, 97: 18.124576854051853, 98: 0, 99: 0, 100: 0, 101: 0, 102: 0}"
28,7,19,29.01416523576155,2,8,24,0.1655262195748094,"[9, 7, 0]",58.148997730927654,3.5720519207390646,19,night_charger,187,195,187,"{187: 58.148997730927654, 188: 54.57694581018859, 189: 43.86079004797139, 190: 26.000530444276073, 191: 0.9961669991026199, 192: 0, 193: 0, 194: 0}"
29,1,20,5.0,1,4,24,0.5124131926512765,"[5, 8, 13]",136.36230009199534,2.486078300974293,20,random,44,48,44,"{44: 136.36230009199534, 45: 133.87622179102104, 46: 126.41798688809817, 47: 113.9875953832267}"
29,7,14,26.281391989647325,2,6,20,0.2846739959173758,"[14, 0, 8]",135.8309440507048,2.9229636496388904,14,random,182,188,182,"{182: 135.8309440507048, 183: 132.9079804010659, 184: 124.13908945214924, 185: 109.52427120395478, 186: 89.06352565648255, 187: 62.756852809732536}"
29,12,16,24.060130107021905,2,5,21,0.24197289652976944,"[4, 9, 0]",142.91163526913255,1.8900841767097858,16,random,304,309,304,"{304: 142.91163526913255, 305: 141.02155109242275, 306: 135.3512985622934, 307: 125.90087767874448, 308: 112.67028844177597}"
30,11,17,34.395198536121974,5,8,24,0.3916558878266557,"[14, 3, 7]",133.10363132726854,3.644001195283412,17,commuter,281,289,281,"{281: 133.10363132726854, 282: 129.45963013198514, 283: 118.5276265461349, 284: 100.30762056971784, 285: 74.79961220273395, 286: 42.00360144518325, 287: 1.9195882970657294, 288: 0}"
30,12,12,63.610996810139056,4,6,18,0.18494861369592075,"[3, 2, 9]",115.7494229984942,1.7784770172982607,12,commuter,300,306,300,"{300: 115.7494229984942, 301: 113.97094598119594, 302: 108.63551492930115, 303: 99.74312984280985, 304: 87.29379072172202, 305: 71.28749756603767}"
30,6,10,60.40842603163778,3,6,16,0.18494861369592075,"[2, 14, 0]",139.38085432166307,4.535317293901942,10,commuter,154,160,154,"{154: 139.38085432166307, 155: 134.8455370277611, 156: 121.2395851460553, 157: 98.56299867654559, 158: 66.815777619232, 159: 25.99792197411452}"
30,3,18,69.97244655939103,4,5,23,0.3916558878266557,"[7, 11, 13]",63.07265165672746,3.2854558786766286,18,commuter,90,95,90,"{90: 63.07265165672746, 91: 59.78719577805083, 92: 49.93082814202094, 93: 33.5035487486378, 94: 10.505357597901401}"
30,8,7,85.96246979402856,8,9,16,0.32637990652221305,"[3, 9, 13]",125.50806621216796,4.011771550734549,7,commuter,199,208,199,"{199: 125.50806621216796, 200: 121.49629466143341, 201: 109.46098000922976, 202: 89.40212225555702, 203: 61.319721400415176, 204: 25.213777443804233, 205: 0, 206: 0, 207: 0}"
31,12,14,51.677749979487736,4,9,23,0.08560240986220065,"[6, 1, 14]",114.14903690642878,4.507675727483388,14,weekend_user,302,311,302,"{302: 114.14903690642878, 303: 109.64136117894539, 304: 96.11833399649522, 305: 73.57995535907828, 306: 42.02622526669457, 307: 1.4571437193440744, 308: 0, 309: 0, 310: 0}"
32,1,19,45.644271316728634,5,7,24,0.3636707877439269,"[14, 4, 13]",142.40778052942693,3.681662058635826,19,commuter,43,50,43,"{43: 142.40778052942693, 44: 138.7261184707911, 45: 127.68113229488362, 46: 109.2728220017045, 47: 83.50118759125371, 48: 50.36622906353128, 49: 9.867946418537201}"
32,9,7,42.774326797572414,4,6,13,0.3030589897866057,"[12, 6, 1]",120.6819445010144,2.95716063001505,7,commuter,223,229,223,"{223: 120.6819445010144, 224: 117.72478387099935, 225: 108.8533019809542, 226: 94.06749883087895, 227: 73.3673744207736, 228: 46.75292875063815}"
32,0,9,56.33723153520783,5,7,16,0.3030589897866057,"[1, 4, 9]",102.99106085609492,1.2759492330347224,9,commuter,9,16,9,"{9: 102.99106085609492, 10: 101.7151116230602, 11: 97.88726392395603, 12: 91.50751775878241, 13: 82.57587312753935, 14: 71.09233003022686, 15: 57.05688846684491}"
32,5,19,50.091963371197544,3,5,24,0.30912016958233784,"[6, 4, 7]",127.27441445464122,1.673541193212218,19,commuter,139,144,139,"{139: 127.27441445464122, 140: 125.600873261429, 141: 120.58024968179234, 142: 112.21254371573126, 143: 100.49775536324573}"
32,0,8,46.41697188761005,4,5,13,0.3030589897866057,"[11, 14, 5]",109.93792222611017,4.748579867260488,8,commuter,8,13,8,"{8: 109.93792222611017, 9: 105.18934235884969, 10: 90.94360275706822, 11: 67.20070342076579, 12: 33.96064434994237}"
33,1,7,31.6208961325933,3,4,11,0.2547438925700611,"[14, 5, 0]",80.02271115413863,3.124437690176622,7,commuter,31,35,31,"{31: 80.02271115413863, 32: 76.89827346396201, 33: 67.52496039343214, 34: 51.90277194254904}"
33,3,9,9.131560547656097,2,5,14,0.2547438925700611,"[1, 5, 8]",88.08851221087684,2.75989506816952,9,commuter,81,86,81,"{81: 88.08851221087684, 82: 85.32861714270732, 83: 77.04893193819876, 84: 63.24945659735116, 85: 43.93019112016452}"
33,4,9,50.70675791366632,3,4,13,0.2547438925700611,"[10, 6, 2]",103.6628904301804,4.831928214436399,9,commuter,105,109,105,"{105: 103.6628904301804, 106: 98.830962215744, 107: 84.3351775724348, 108: 60.175536500252804}"
34,7,7,27.091482417581105,2,4,11,0.11719012876383736,"[1, 6, 14]",81.86751537328657,2.6395365235010826,7,commuter,175,179,175,"{175: 81.86751537328657, 176: 79.22797884978549, 177: 71.30936927928224, 178: 58.11168666177682}"
34,10,18,49.94055217281076,5,8,24,0.14062815451660485,"[7, 9, 14]",142.82167956475945,3.1152208726270656,18,commuter,258,266,258,"{258: 142.82167956475945, 259: 139.70645869213237, 260: 130.3607960742512, 261: 114.78469171111585, 262: 92.9781456027264, 263: 64.9411577490828, 264: 30.673728150185084, 265: 0}"
34,12,14,51.40994147833534,6,7,21,0.06640773963284118,"[3, 6, 9]",51.81579656070788,3.889845241355816,14,commuter,302,309,302,"{302: 51.81579656070788, 303: 47.925951319352066, 304: 36.256415595284615, 305: 16.807189388505535, 306: 0, 307: 0, 308: 0}"
34,5,18,22.119980947539077,2,4,22,0.11953393133911411,"[13, 11, 14]",144.01218933105326,2.529304658240961,18,commuter,138,142,138,"{138: 144.01218933105326, 139: 141.4828846728123, 140: 133.89497069808942, 141: 121.24844740688462}"
35,1,19,8.996357544595856,1,3,22,0.20145143707662846,"[11, 1, 3]",58.42921884374135,3.480126430712939,19,commuter,43,46,43,"{43: 58.42921884374135, 44: 54.94909241302842, 45: 44.508713120889595}"
35,0,17,27.733815249880273,2,5,22,0.20145143707662846,"[5, 12, 4]",144.30488106376202,1.718535305488563,17,commuter,17,22,17,"{17: 144.30488106376202, 18: 142.58634575827347, 19: 137.43073984180776, 20: 128.83806331436494, 21: 116.80831617594501}"
35,12,13,36.49778958111243,3,6,19,0.09512984528618566,"[4, 12, 11]",82.90958803147595,3.1358261877397355,13,commuter,301,307,301,"{301: 82.90958803147595, 302: 79.77376184373621, 303: 70.36628328051701, 304: 54.68715234181833, 305: 32.73636902764018, 306: 4.513933337982564}"
36,5,11,22.342749951948374,2,8,19,0.07840873871658117,"[4, 6, 8]",109.31127783247274,2.4892592310970607,11,weekend_user,131,139,131,"{131: 109.31127783247274, 132: 106.82201860137567, 133: 99.35424090808449, 134: 86.90794475259919, 135: 69.48313013491978, 136: 47.07979705504622, 137: 19.69794551297855, 138: 0}"
37,5,18,46.50179482664588,7,11,24,0.1716566637804552,"[3, 10, 9]",88.25888236709201,2.303320079749578,18,work_charger,138,149,138,"{138: 88.25888236709201, 139: 85.95556228734243, 140: 79.0456020480937, 141: 67.52900164934582, 142: 51.40576109109877, 143: 30.67588037335257, 144: 5.339359496107207, 145: 0, 146: 0, 147: 0, 148: 0}"
37,2,13,50.71502363824863,3,6,19,0.11219389789572236,"[3, 9, 2]",76.51808751303228,4.34098219095201,13,work_charger,61,67,61,"{61: 76.51808751303228, 62: 72.17710532208028, 63: 59.154158749224244, 64: 37.44924779446419, 65: 7.062372457800123, 66: 0}"
37,10,12,55.42218368700613,4,8,20,0.11219389789572236,"[8, 9, 12]",126.13886651049474,4.951901283909481,12,work_charger,252,260,252,"{252: 126.13886651049474, 253: 121.18696522658526, 254: 106.33126137485681, 255: 81.57175495530942, 256: 46.90844596794304, 257: 2.3413344127577034, 258: 0, 259: 0}"
38,5,17,22.03464621272082,2,4,21,0.17271606604886652,"[2, 12, 3]",55.69014804976216,1.2099687358121196,17,commuter,137,141,137,"{137: 55.69014804976216, 138: 54.48017931395004, 139: 50.85027310651368, 140: 44.80042942745308}"
38,1,8,29.61200105850387,4,6,14,0.16932947651849659,"[1, 6, 9]",77.11503611772196,2.186845234114739,8,commuter,32,38,32,"{32: 77.11503611772196, 33: 74.92819088360721, 34: 68.367655181263, 35: 57.43342901068931, 36: 42.12551237188613, 37: 22.443905264853477}"
38,7,9,19.226159801470335,2,3,12,0.16932947651849659,"[1, 9, 2]",101.02159340784041,3.116413070641754,9,commuter,177,180,177,"{177: 101.02159340784041, 178: 97.90518033719866, 179: 88.55594112527339}"
39,5,8,72.10984436455907,5,7,15,0.2982559092995199,"[3, 12, 6]",68.7173114926947,4.0932161604575015,8,random,128,135,128,"{128: 68.7173114926947, 129: 64.6240953322372, 130: 52.3444468508647, 131: 31.878366048577192, 132: 3.2258529253746815, 133: 0, 134: 0}"
39,10,11,26.596820624872166,2,3,14,0.2339262033721725,"[14, 9, 0]",140.06565507683996,3.2809518583081925,11,random,251,254,251,"{251: 140.06565507683996, 252: 136.78470321853177, 253: 126.94184764360719}"
39,8,17,25.152119467737485,2,3,20,0.4210671660699105,"[0, 12, 8]",83.81435382241962,2.003569505415405,17,random,209,212,209,"{209: 83.81435382241962, 210: 81.81078431700422, 211: 75.800075800758}"
40,6,20,16.90244940196684,1,5,24,0.22599820551074626,"[6, 10, 9]",74.58383376805176,4.467154392600968,20,weekend_user,164,169,164,"{164: 74.58383376805176, 165: 70.11667937545079, 166: 56.71521619764789, 167: 34.37944423464305, 168: 3.10936348643628}"
40,12,15,31.52835131702839,5,11,24,0.12555455861708126,"[11, 10, 2]",74.53104979859799,4.86316612042787,15,weekend_user,303,314,303,"{303: 74.53104979859799, 304: 69.66788367817011, 305: 55.07838531688651, 306: 30.76255471474716, 307: 0, 308: 0, 309: 0, 310: 0, 311: 0, 312: 0, 313: 0}"
41,12,17,24.19149210878065,2,6,23,0.2484717235006093,"[6, 3, 11]",54.23349459024921,1.0447972210228165,17,work_charger,305,311,305,"{305: 54.23349459024921, 306: 53.18869736922639, 307: 50.05430570615794, 308: 44.83031960104386, 309: 37.516739053884145, 310: 28.113564064678798}"
41,8,8,30.353423995759595,4,6,14,0.243599728922166,"[4, 3, 1]",53.889581224682615,3.8981626962439253,8,work_charger,200,206,200,"{200: 53.889581224682615, 201: 49.99141852843869, 202: 38.29693043970691, 203: 18.806116958487287, 204: 0, 205: 0}"
41,2,13,33.347461146886424,5,10,23,0.162399819281444,"[10, 2, 0]",64.255625713494,4.353176468003054,13,work_charger,61,71,61,"{61: 64.255625713494, 62: 59.90244924549094, 63: 46.84291984148179, 64: 25.077037501466513, 65: 0, 66: 0, 67: 0, 68: 0, 69: 0, 70: 0}"
41,2,8,21.82260018453874,2,6,14,0.243599728922166,"[3, 14, 7]",107.90725276859945,1.9276044870756595,8,work_charger,56,62,56,"{56: 107.90725276859945, 57: 105.9796482815238, 58: 100.19683482029681, 59: 90.55881238491851, 60: 77.0655809753889, 61: 59.71714059170796}"
42,8,19,44.27290434321,5,10,24,0.24859759915734608,"[12, 0, 2]",138.65641126311522,3.9190905493446295,19,night_charger,211,221,211,"{211: 138.65641126311522, 212: 134.7373207137706, 213: 122.9800490657367, 214: 103.38459631901355, 215: 75.95096247360115, 216: 40.679147529499474, 217: 0, 218: 0, 219: 0, 220: 0}"
42,0,22,49.73121888849011,4,12,24,0.1381097773096367,"[2, 8, 11]",141.68748289238192,4.403210406598051,22,night_charger,22,34,22,"{22: 141.68748289238192, 23: 137.28427248578387, 24: 124.07464126598973, 25: 102.05858923299947, 26: 71.23611638681311, 27: 31.607222727430653, 28: 0, 29: 0, 30: 0, 31: 0, 32: 0, 33: 0}"
43,5,20,45.02585065653364,6,12,24,0.1351975249887512,"[3, 13, 6]",50.437398228300935,2.095487278821484,20,weekend_user,140,152,140,"{140: 50.437398228300935, 141: 48.34191094947945, 142: 42.055449113015, 143: 31.57801271890758, 144: 16.90960176715719, 145: 0, 146: 0, 147: 0, 148: 0, 149: 0, 150: 0, 151: 0}"
43,12,16,67.10508968704748,8,12,24,0.0751097361048618,"[2, 13, 11]",108.97796007780784,4.076747159983713,16,weekend_user,304,316,304,"{304: 108.97796007780784, 305: 104.90121291782413, 306: 92.67097143787299, 307: 72.28723563795442, 308: 43.750005518068434, 309: 7.059281078215022, 310: 0, 311: 0, 312: 0, 313: 0, 314: 0, 315: 0}"
44,12,19,26.814141115432154,2,5,24,0.21693942388940163,"[9, 4, 2]",71.89802298915575,3.31105226999083,19,weekend_user,307,312,307,"{307: 71.89802298915575, 308: 68.58697071916492, 309: 58.65381390919243, 310: 42.09855255923828, 311: 18.92118666930247}"
44,6,13,37.55167301524889,3,9,22,0.1205219021607787,"[4, 3, 13]",120.80113308712896,4.473850315789882,13,weekend_user,157,166,157,"{157: 120.80113308712896, 158: 116.32728277133907, 159: 102.90573182396943, 160: 80.53648024502002, 161: 49.21952803449085, 162: 8.954875192381905, 163: 0, 164: 0, 165: 0}"
45,1,21,47.73782177408201,3,8,24,0.12738364211012648,"[4, 8, 6]",148.08433682238984,2.4250121715952053,21,night_charger,45,53,45,"{45: 148.08433682238984, 46: 145.65932465079464, 47: 138.38428813600902, 48: 126.259227278033, 49: 109.28414207686656, 50: 87.45903253250971, 51: 60.78389864496245, 52: 29.25874041422479}"
45,4,22,58.90452783545902,6,11,24,0.12738364211012648,"[8, 11, 3]",126.36319155471341,3.751936086094679,22,night_charger,118,129,118,"{118: 126.36319155471341, 119: 122.61125546861874, 120: 111.35544721033469, 121: 92.5957667798613, 122: 66.33221417719855, 123: 32.564789402346435, 124: 0, 125: 0, 126: 0, 127: 0, 128: 0}"
45,3,23,24.52515402411131,2,8,24,0.08916854947708854,"[12, 0, 8]",98.87061683916019,4.559854820548991,23,night_charger,95,103,95,"{95: 98.87061683916019, 96: 94.3107620186112, 97: 80.63119755696422, 98: 57.83192345421927, 99: 25.912939710376335, 100: 0, 101: 0, 102: 0}"
46,3,18,42.04162189502854,4,6,24,0.24633416315923687,"[2, 6, 4]",142.55443258622233,2.502823221521082,18,commuter,90,96,90,"{90: 142.55443258622233, 91: 140.05160936470125, 92: 132.543139700138, 93: 120.0290235925326, 94: 102.50926104188503, 95: 79.98385204819527}"
46,9,7,29.55559304253179,3,5,12,0.20527846929936402,"[12, 6, 2]",117.37116477208488,1.031038593349698,7,commuter,223,228,223,"{223: 117.37116477208488, 224: 116.34012617873519, 225: 113.24701039868609, 226: 108.0918174319376, 227: 100.87454727848971}"
46,4,8,51.376195395493156,6,7,15,0.20527846929936402,"[12, 8, 7]",143.04234931787778,4.5598634749867255,8,commuter,104,111,104,"{104: 143.04234931787778, 105: 138.48248584289107, 106: 124.80289541793087, 107: 102.00357804299725, 108: 70.08453371809017, 109: 29.04576244320964, 110: 0}"
47,10,12,24.97040854000472,2,4,16,0.23433400694052278,"[8, 11, 6]",125.80735014207993,2.5729227918915103,12,random,252,256,252,"{252: 125.80735014207993, 253: 123.23442735018841, 254: 115.51565897451388, 255: 102.65104501505633}"
48,12,19,26.577810982889574,2,6,24,0.1975709129942048,"[8, 6, 10]",86.4290754673579,1.9222025962814673,19,work_charger,307,313,307,"{307: 86.4290754673579, 308: 84.50687287107644, 309: 78.74026508223204, 310: 69.1292521008247, 311: 55.67383392685443, 312: 38.374010560321224}"
48,11,9,15.415513461493692,2,7,16,0.1936969735237302,"[10, 5, 0]",63.33992351774894,3.7454889310905735,9,work_charger,273,280,273,"{273: 63.33992351774894, 274: 59.594434586658366, 275: 48.35796779338665, 276: 29.63052313793378, 277: 3.4121006202997677, 278: 0, 279: 0}"
48,5,19,26.130831477068593,2,7,24,0.1975709129942048,"[14, 6, 11]",68.26630488570137,3.439474939942151,19,work_charger,139,146,139,"{139: 68.26630488570137, 140: 64.82682994575923, 141: 54.50840512593277, 142: 37.31103042622202, 143: 13.234705846626959, 144: 0, 145: 0}"
48,6,15,16.642830702579765,2,6,21,0.10976161833011379,"[9, 3, 6]",84.34305880194931,2.6036108903165043,15,work_charger,159,165,159,"{159: 84.34305880194931, 160: 81.73944791163281, 161: 73.9286152406833, 162: 60.91056078910077, 163: 42.68528455688524, 164: 19.25278654403671}"
49,3,7,38.56294629399278,3,4,11,0.2835846426272721,"[6, 12, 8]",104.70281464244478,1.213360652020734,7,commuter,79,83,79,"{79: 104.70281464244478, 80: 103.48945399042404, 81: 99.84937203436183, 82: 93.78256877425817}"
49,0,18,40.40155015958711,4,6,24,0.3403015711527266,"[6, 2, 14]",98.84408067135001,3.011134843087887,18,commuter,18,24,18,"{18: 98.84408067135001, 19: 95.83294582826213, 20: 86.79954129899846, 21: 71.74386708355902, 22: 50.665923181943825, 23: 23.56570959415285}"
49,6,16,45.27305601285489,3,5,21,0.16069796415545423,"[6, 3, 8]",130.39435307760522,4.199966690222139,16,commuter,160,165,160,"{160: 130.39435307760522, 161: 126.19438638738308, 162: 113.59448631671665, 163: 92.59465286560597, 164: 63.194886034050995}"
50,0,9,80.78734471798002,8,12,21,0.2884301278069436,"[7, 14, 2]",59.525245490432525,1.4776025683052545,9,work_charger,9,21,9,"{9: 59.525245490432525, 10: 58.04764292212727, 11: 53.61483521721151, 12: 46.22682237568523, 13: 35.88360439754845, 14: 22.58518128280116, 15: 6.331553031443363, 16: 0, 17: 0, 18: 0, 19: 0, 20: 0}"
50,12,11,60.96930413034097,5,9,20,0.16344373909060142,"[12, 13, 6]",109.41046382754251,3.8325893383942287,11,work_charger,299,308,299,"{299: 109.41046382754251, 300: 105.57787448914829, 301: 94.0801064739656, 302: 74.91715978199446, 303: 48.089034413234856, 304: 13.595730367686798, 305: 0, 306: 0, 307: 0}"
50,9,8,56.79904727911379,4,6,14,0.2884301278069436,"[3, 8, 0]",62.17663775995654,4.46076324442558,8,work_charger,224,230,224,"{224: 62.17663775995654, 225: 57.71587451553096, 226: 44.33358478225422, 227: 22.02976856012632, 228: 0, 229: 0}"
51,7,9,42.24539565447182,3,5,14,0.3509843866785085,"[9, 5, 2]",83.76561688009394,2.9614017642226433,9,commuter,177,182,177,"{177: 83.76561688009394, 178: 80.8042151158713, 179: 71.92000982320337, 180: 57.11300100209016, 181: 36.38318865253165}"
51,4,7,61.47751267890573,7,10,17,0.3509843866785085,"[9, 2, 5]",58.70335650915543,2.1466369937890106,7,commuter,103,113,103,"{103: 58.70335650915543, 104: 56.55671951536642, 105: 50.11680853399938, 106: 39.383623565054336, 107: 24.357164608531257, 108: 5.037431664430159, 109: 0, 110: 0, 111: 0, 112: 0}"
51,2,19,19.473424253938,2,4,23,0.42118126401421024,"[6, 3, 5]",100.16298089230942,1.0931483177703276,19,commuter,67,71,67,"{67: 100.16298089230942, 68: 99.06983257453909, 69: 95.7903876212281, 70: 90.32464603237648}"
51,6,14,67.01713504542532,6,9,23,0.19889115245115482,"[11, 5, 14]",82.08813990366434,2.9181645004249135,14,commuter,158,167,158,"{158: 82.08813990366434, 159: 79.16997540323943, 160: 70.41548190196468, 161: 55.824659399840115, 162: 35.397507896865726, 163: 9.134027393041507, 164: 0, 165: 0, 166: 0}"
51,4,18,63.867747546772144,8,11,24,0.42118126401421024,"[2, 13, 1]",81.83152001347766,1.219148987699655,18,commuter,114,125,114,"{114: 81.83152001347766, 115: 80.612371025778, 116: 76.95492406267904, 117: 70.85917912418077, 118: 62.325136210283176, 119: 51.35279532098628, 120: 37.94215645629008, 121: 22.09321961619456, 122: 3.8059848006997328, 123: 0, 124: 0}"
52,12,13,28.89582031387327,4,7,20,0.12318763677148149,"[1, 11, 12]",129.89649025337457,2.448913455754641,13,commuter,301,308,301,"{301: 129.89649025337457, 302: 127.44757679761993, 303: 120.100836430356, 304: 107.8562691515828, 305: 90.71387496130032, 306: 68.67365385950855, 307: 41.73560584620749}"
52,5,17,50.2177949707318,3,5,22,0.22173774618866665,"[0, 13, 1]",105.17792837256954,2.096216829718191,17,commuter,137,142,137,"{137: 105.17792837256954, 138: 103.08171154285135, 139: 96.79306105369677, 140: 86.31197690510582, 141: 71.63845909707848}"
52,3,9,20.201738110026483,2,3,12,0.21738994724379082,"[4, 5, 13]",141.07518127381474,3.8627059204903076,9,commuter,81,84,81,"{81: 141.07518127381474, 82: 137.21247535332444, 83: 125.62435759185351}"
52,10,17,60.233627965325226,5,6,23,0.26086793669254904,"[8, 5, 14]",132.11236261177243,2.739920791552181,17,commuter,257,263,257,"{257: 132.11236261177243, 258: 129.37244182022025, 259: 121.1526794455637, 260: 107.4530754878028, 261: 88.27362994693753, 262: 63.6143428229679}"
52,10,8,42.46686385763833,3,5,13,0.21738994724379082,"[11, 4, 7]",57.3963187270956,1.699987315002336,8,commuter,248,253,248,"{248: 57.3963187270956, 249: 55.69633141209326, 250: 50.596369467086255, 251: 42.096432892074574, 252: 30.196521687058222}"
53,1,7,12.635036133591079,1,2,9,0.13751183290066668,"[12, 6, 8]",139.18048860851022,4.655185037706516,7,commuter,31,33,31,"{31: 139.18048860851022, 32: 134.52530357080371}"
53,13,19,77.22652932151945,4,7,24,0.14026206955868,"[0, 5, 3]",73.29722120780391,4.621957909965303,19,commuter,331,338,331,"{331: 73.29722120780391, 332: 68.67526329783861, 333: 54.8093895679427, 334: 31.699600018116186, 335: 0}"
53,1,18,36.0990281819228,4,5,23,0.16501419948080004,"[9, 6, 2]",138.69870695233197,1.7934258729973322,18,commuter,42,47,42,"{42: 138.69870695233197, 43: 136.90528107933466, 44: 131.52500346034265, 45: 122.55787409535598, 46: 110.00389298437466}"
54,3,7,39.80127409702695,3,6,13,0.24599236458803192,"[7, 11, 2]",78.5664988846723,4.459067968368791,7,commuter,79,85,79,"{79: 78.5664988846723, 80: 74.10743091630351, 81: 60.73022701119714, 82: 38.43488716935318, 83: 7.2214113907716495, 84: 0}"
54,3,7,50.83053699499946,6,9,16,0.24599236458803192,"[14, 13, 1]",63.19298257538108,2.982036709322553,7,commuter,79,88,79,"{79: 63.19298257538108, 80: 60.21094586605853, 81: 51.264835738090866, 82: 36.3546521914781, 83: 15.480395226220232, 84: 0, 85: 0, 86: 0, 87: 0}"
54,5,19,35.56737030751225,3,5,24,0.25091221187979257,"[1, 4, 3]",51.58933931400036,3.1476050820816877,19,commuter,139,144,139,"{139: 51.58933931400036, 140: 48.44173423191867, 141: 38.99891898567361, 142: 23.26089357526517, 143: 1.22765800069336}"
54,1,9,44.679177532725106,4,7,16,0.24599236458803192,"[1, 8, 11]",66.42979839524723,4.013038154383275,9,commuter,33,40,33,"{33: 66.42979839524723, 34: 62.41676024086396, 35: 50.377645777714136, 36: 30.31245500579776, 37: 2.221187925114833, 38: 0, 39: 0}"
55,13,18,39.078744109166585,3,6,24,0.23695859087159826,"[1, 10, 3]",80.67727513528322,2.900909868006961,18,weekend_user,330,336,330,"{330: 80.67727513528322, 331: 77.77636526727626, 332: 69.07363566325537, 333: 54.569086323220574, 334: 34.26271724717185, 335: 8.1545284351092}"
55,12,12,28.26078680000321,3,9,21,0.1316436615953324,"[9, 10, 4]",82.23333118004737,2.7519909915822165,12,weekend_user,300,309,300,"{300: 82.23333118004737, 301: 79.48134018846515, 302: 71.2253672137185, 303: 57.46541225580742, 304: 38.20147531473191, 305: 13.433556390491958, 306: 0, 307: 0, 308: 0}"
56,5,12,71.46821112860371,5,7,19,0.08708945088903337,"[7, 12, 13]",100.92452505028751,3.777098985743452,12,work_charger,132,139,132,"{132: 100.92452505028751, 133: 97.14742606454406, 134: 85.81612910731371, 135: 66.93063417859645, 136: 40.490941278392285, 137: 6.49705040670122, 138: 0}"
56,5,12,40.498343498811494,3,5,17,0.08708945088903337,"[9, 4, 1]",51.02338564087575,1.0886381421780862,12,work_charger,132,137,132,"{132: 51.02338564087575, 133: 49.93474749869767, 134: 46.66883307216341, 135: 41.225642361272975, 136: 33.60517536602637}"
56,4,9,35.26850596339858,2,5,14,0.15368726627476476,"[3, 0, 7]",71.926570159258,2.2210145164017723,9,work_charger,105,110,105,"{105: 71.926570159258, 106: 69.70555564285624, 107: 63.04251209365091, 108: 51.937439511642054, 109: 36.39033789682965}"
57,3,11,34.69099606613346,2,4,15,0.18897370699412483,"[13, 8, 5]",114.15702955650998,4.272848005481853,11,work_charger,83,87,83,"{83: 114.15702955650998, 84: 109.88418155102814, 85: 97.06563753458258, 86: 75.70139750717331}"
57,0,11,61.77955725664553,6,9,20,0.18897370699412483,"[10, 14, 11]",79.05635115774552,2.1112779788215223,11,work_charger,11,20,11,"{11: 79.05635115774552, 12: 76.945073178924, 13: 70.61123924245943, 14: 60.05484934835182, 15: 45.27590349660117, 16: 26.274401687207465, 17: 3.050343920170718, 18: 0, 19: 0}"
57,13,17,44.140922643699476,3,6,23,0.28912977170101095,"[2, 11, 1]",53.019201533718864,1.4213355769798572,17,work_charger,329,335,329,"{329: 53.019201533718864, 330: 51.59786595673901, 331: 47.333859225799436, 332: 40.227181340900145, 333: 30.277832302041148, 334: 17.48581210922243}"
58,6,22,32.217720341741085,3,11,24,0.06908933071705355,"[7, 12, 9]",59.24229169050702,2.720743467114052,22,night_charger,166,177,166,"{166: 59.24229169050702, 167: 56.52154822339296, 168: 48.35931782205081, 169: 34.755600486480546, 170: 15.710396216682184, 171: 0, 172: 0, 173: 0, 174: 0, 175: 0, 176: 0}"
58,10,22,30.325656661296332,2,9,24,0.08128156554947476,"[13, 6, 7]",143.59551537286035,1.6589641534530877,22,night_charger,262,271,262,"{262: 143.59551537286035, 263: 141.93655121940725, 264: 136.959658759048, 265: 128.66483799178255, 266: 117.05208891761094, 267: 102.12141153653316, 268: 83.87280584854919, 269: 62.306271853659055, 270: 37.42180955186274}"
59,6,19,34.79097699537975,2,4,23,0.179256852423765,"[9, 2, 13]",59.33281202698264,1.690629604390359,19,commuter,163,167,163,"{163: 59.33281202698264, 164: 57.64218242259228, 165: 52.5702936094212, 166: 44.11714558746941}"
59,7,17,55.38852277761383,5,6,23,0.21089041461619415,"[14, 1, 11]",81.4241520499505,4.894106207349007,17,commuter,185,191,185,"{185: 81.4241520499505, 186: 76.53004584260148, 187: 61.84772722055446, 188: 37.37719618380943, 189: 3.1184527323663787, 190: 0}"
59,12,19,38.493191563226546,3,5,24,0.179256852423765,"[7, 12, 14]",51.48301624317079,4.236412867292184,19,commuter,307,312,307,"{307: 51.48301624317079, 308: 47.24660337587861, 309: 34.53736477400205, 310: 13.355300437541125, 311: 0}"
59,12,10,38.98863888572431,3,6,16,0.099587140235425,"[1, 0, 10]",112.96726518598874,4.947654856872849,10,commuter,298,304,298,"{298: 112.96726518598874, 299: 108.01961032911589, 300: 93.17664575849734, 301: 68.43837147413309, 302: 33.80478747602315, 303: 0}"
59,2,17,51.128756756992715,3,4,21,0.21089041461619415,"[13, 6, 3]",61.97669319108849,3.7999593382086347,17,commuter,65,69,65,"{65: 61.97669319108849, 66: 58.176733852879856, 67: 46.77685583825395, 68: 27.777059147210778}"
60,3,13,41.56641057231167,5,6,19,0.12805142157394955,"[2, 5, 6]",106.03798601367683,2.591829109183077,13,random,85,91,85,"{85: 106.03798601367683, 86: 103.44615690449375, 87: 95.67066957694452, 88: 82.71152403102914, 89: 64.56872026674759, 90: 41.242258284099904}"
61,7,21,35.218486579220446,2,3,24,0.11221411032463784,"[3, 0, 12]",119.18185861250508,1.4864726272785975,21,random,189,192,189,"{189: 119.18185861250508, 190: 117.69538598522648, 191: 113.23596810339069}"
62,9,11,38.706818378310146,3,7,18,0.20025326160178267,"[6, 14, 10]",72.7514963074645,1.4075625840135837,11,random,227,234,227,"{227: 72.7514963074645, 228: 71.34393372345092, 229: 67.12124597141018, 230: 60.083433051342254, 231: 50.23049496324717, 232: 37.562431707124915, 233: 22.079243282975497}"
62,13,18,45.80005318591314,3,5,23,0.3063874902507275,"[14, 13, 12]",74.46861881232726,4.368998340796937,18,random,330,335,330,"{330: 74.46861881232726, 331: 70.09962047153033, 332: 56.99262544913952, 333: 35.147633745154835, 334: 4.564645359576275}"
62,12,12,49.36609836945403,5,6,18,0.1702152723615153,"[3, 2, 10]",95.04409954259332,2.2941196567125557,12,random,300,306,300,"{300: 95.04409954259332, 301: 92.74997988588076, 302: 85.86762091574309, 303: 74.39702263218031, 304: 58.338185035192424, 305: 37.691108124779426}"
63,7,9,67.51068127741254,4,5,14,0.15842730741742883,"[5, 2, 11]",91.607023555328,1.373727467369997,9,commuter,177,182,177,"{177: 91.607023555328, 178: 90.233296087958, 179: 86.11211368584802, 180: 79.24347634899803, 181: 69.62738407740804}"
63,13,19,64.40738969344329,8,11,24,0.1615958535657774,"[3, 12, 13]",132.62577293320692,2.336308869671389,19,commuter,331,342,331,"{331: 132.62577293320692, 332: 130.28946406353552, 333: 123.28053745452137, 334: 111.59899310616441, 335: 95.2448310184647}"
63,12,17,69.82524556674757,4,5,22,0.1615958535657774,"[0, 9, 5]",54.546462720492585,1.6313079251991942,17,commuter,305,310,305,"{305: 54.546462720492585, 306: 52.91515479529339, 307: 48.021231019695804, 308: 39.864691393699836, 309: 28.445535917305477}"
63,10,17,63.23598545295961,4,5,22,0.19011276890091464,"[6, 12, 1]",75.77400613115186,4.007195778074834,17,commuter,257,262,257,"{257: 75.77400613115186, 258: 71.76681035307703, 259: 59.74522301885253, 260: 39.70924412847836, 261: 11.658873681954518}"
63,0,8,81.6857072751358,8,10,18,0.15842730741742883,"[6, 13, 3]",64.18288286876749,1.0149803788451393,8,commuter,8,18,8,"{8: 64.18288286876749, 9: 63.167902489922355, 10: 60.122961353386934, 11: 55.04805945916124, 12: 47.943196807245265, 13: 38.808373397639016, 14: 27.643589230342478, 15: 14.44884430535567, 16: 0, 17: 0}"
64,7,12,25.33763530123898,2,6,18,0.14358860990917496,"[14, 11, 7]",51.90992798417149,1.136382791413081,12,random,180,186,180,"{180: 51.90992798417149, 181: 50.773545192758405, 182: 47.36439681851917, 183: 41.682482861453764, 184: 33.72780332156219, 185: 23.500358198844463}"
64,10,19,56.196720067928425,5,8,24,0.25845949783651495,"[0, 13, 6]",143.85888581772966,2.267781154542342,19,random,259,267,259,"{259: 143.85888581772966, 260: 141.5911046631873, 261: 134.7877611995603, 262: 123.44885542684858, 263: 107.57438734505219, 264: 87.16435695417111, 265: 62.218764254205354, 266: 32.7376092451549}"
64,5,10,61.26225869934529,8,9,19,0.12205031842279873,"[11, 2, 3]",62.734877637588525,4.617507334643971,10,random,130,139,130,"{130: 62.734877637588525, 131: 58.11737030294455, 132: 44.26484829901264, 133: 21.177311625792782, 134: 0, 135: 0, 136: 0, 137: 0, 138: 0}"
65,2,19,25.667100373533778,2,4,23,0.14627966034163192,"[12, 3, 2]",76.42439368122123,4.639820253090438,19,random,67,71,67,"{67: 76.42439368122123, 68: 71.7845734281308, 69: 57.86511266885948, 70: 34.666011403407296}"
66,13,14,51.106607871607174,4,8,22,0.16925947624693127,"[10, 12, 6]",101.0138541910402,3.6706958040331474,14,weekend_user,326,334,326,"{326: 101.0138541910402, 327: 97.34315838700705, 328: 86.3310709749076, 329: 67.97759195474187, 330: 42.28272132650984, 331: 9.246459090211516, 332: 0, 333: 0}"
66,13,19,30.36419601257257,2,8,24,0.30466705724447624,"[11, 9, 13]",104.3543914649442,1.9530496533597201,19,weekend_user,331,339,331,"{331: 104.3543914649442, 332: 102.40134181158447, 333: 96.54219285150532, 334: 86.77694458470671, 335: 73.10559701118868}"
67,13,16,43.23983420244724,5,8,24,0.10114418620521781,"[10, 7, 12]",52.41327786925536,3.4416474430422843,16,work_charger,328,336,328,"{328: 52.41327786925536, 329: 48.971630426213075, 330: 38.646688097086226, 331: 21.4384508818748, 332: 0, 333: 0, 334: 0, 335: 0}"
67,10,11,29.536516270394074,2,6,17,0.11899316024143271,"[10, 12, 11]",100.98740563064028,4.243282151352605,11,work_charger,251,257,251,"{251: 100.98740563064028, 252: 96.74412347928768, 253: 84.01427702522986, 254: 62.79786626846684, 255: 33.094891208998604, 256: 0}"
67,0,11,30.869887673755354,4,7,18,0.11899316024143271,"[9, 3, 1]",68.95954901766927,1.1271565982205507,11,work_charger,11,18,11,"{11: 68.95954901766927, 12: 67.83239241944872, 13: 64.45092262478707, 14: 58.81513963368432, 15: 50.925043446140464, 16: 40.78063406215551, 17: 28.381911481729446}"
68,11,9,39.22507560049833,3,6,15,0.16103993790988527,"[4, 7, 14]",122.39842652481514,3.6477983459195733,9,random,273,279,273,"{273: 122.39842652481514, 274: 118.75062817889557, 275: 107.80723314113685, 276: 89.56824141153898, 277: 64.03365299010196, 278: 31.203467876825798}"
68,7,15,15.459649444248054,1,3,18,0.1073599586065902,"[8, 9, 0]",71.10383302086154,1.2973234894143206,15,random,183,186,183,"{183: 71.10383302086154, 184: 69.80650953144722, 185: 65.91453906320426}"
68,12,18,60.90240833617986,4,6,24,0.164260736668083,"[11, 9, 4]",124.05189396178675,4.449212944105596,18,random,306,312,306,"{306: 124.05189396178675, 307: 119.60268101768115, 308: 106.25504218536436, 309: 84.00897746483639, 310: 52.864486856097216, 311: 12.821570359146861}"
69,8,21,80.52461058862272,5,12,24,0.27268988809408284,"[0, 4, 1]",52.89805902499762,1.4514776705872885,21,night_charger,213,225,213,"{213: 52.89805902499762, 214: 51.446581354410334, 215: 47.09214834264847, 216: 39.834759989712026, 217: 29.674416295601006, 218: 16.61111726031541, 219: 0.6448628838552395, 220: 0, 221: 0, 222: 0, 223: 0, 224: 0}"
69,1,21,30.170161395467105,2,9,24,0.27268988809408284,"[5, 2, 1]",122.27620328396968,2.0700474294154665,21,night_charger,45,54,45,"{45: 122.27620328396968, 46: 120.20615585455421, 47: 113.99601356630781, 48: 103.64577641923049, 49: 89.15544441332221, 50: 70.52501754858301, 51: 47.75449582501288, 52: 20.84387924261182, 53: 0}"
70,5,19,43.13828746248878,5,11,24,0.21950386276493422,"[7, 12, 11]",84.8994935301911,2.815413022740209,19,night_charger,139,150,139,"{139: 84.8994935301911, 140: 82.08408050745089, 141: 73.63784143923026, 142: 59.56077632552921, 143: 39.85288516634775, 144: 14.514167961685857, 145: 0, 146: 0, 147: 0, 148: 0, 149: 0}"
70,13,19,30.331475926797374,2,7,24,0.21950386276493422,"[3, 12, 9]",81.77605068249542,1.9287391338811677,19,night_charger,331,338,331,"{331: 81.77605068249542, 332: 79.84731154861426, 333: 74.06109414697076, 334: 64.41739847756492, 335: 50.91622454039674}"
71,10,8,44.99057971428658,3,5,13,0.140717094760708,"[12, 9, 2]",108.7358206218895,2.808730741446777,8,commuter,248,253,248,"{248: 108.7358206218895, 249: 105.92708988044272, 250: 97.5008976561024, 251: 83.45724394886851, 252: 63.79612875874107}"
71,9,7,24.29481949443042,2,3,10,0.140717094760708,"[11, 10, 6]",142.32824157031447,1.2916680477080216,7,commuter,223,226,223,"{223: 142.32824157031447, 224: 141.03657352260646, 225: 137.1615693794824}"
71,5,17,38.2458825384352,4,7,24,0.1435314366559222,"[7, 11, 12]",108.37322501601248,2.612141955738741,17,commuter,137,144,137,"{137: 108.37322501601248, 138: 105.76108306027375, 139: 97.92465719305753, 140: 84.86394741436382, 141: 66.57895372419263, 142: 43.06967612254397, 143: 14.336114609417805}"
72,2,13,23.729736704298997,2,7,20,0.08667683137326866,"[0, 5, 3]",60.43466133255606,1.3006342613523394,13,work_charger,61,68,61,"{61: 60.43466133255606, 62: 59.13402707120372, 63: 55.2321242871467, 64: 48.728952980385, 65: 39.62451315091863, 66: 27.918804798747573, 67: 13.611827923871843}"
72,13,17,18.592860987783986,1,4,21,0.13261555200110103,"[1, 5, 8]",130.95872708095527,3.2145808719969393,17,work_charger,329,333,329,"{329: 130.95872708095527, 330: 127.74414620895833, 331: 118.10040359296751, 332: 102.02749923298282}"
72,4,13,51.41949176914407,4,8,21,0.08667683137326866,"[9, 8, 5]",93.37844022073728,3.373084371951969,13,work_charger,109,117,109,"{109: 93.37844022073728, 110: 90.0053558487853, 111: 79.8861027329294, 112: 63.02068087316955, 113: 39.40909026950577, 114: 9.051330921938046, 115: 0, 116: 0}"
73,5,10,29.669610847561362,4,6,16,0.1314781349513439,"[6, 8, 12]",66.16160607302974,2.1713424898410416,10,work_charger,130,136,130,"{130: 66.16160607302974, 131: 63.99026358318871, 132: 57.47623611366558, 133: 46.619523664460374, 134: 31.42012623557308, 135: 11.878043827003708}"
73,9,10,34.745745200586576,4,9,19,0.15468015876628693,"[14, 13, 12]",139.3952260552547,4.105126656073171,10,work_charger,226,235,226,"{226: 139.3952260552547, 227: 135.29009939918154, 228: 122.97471943096203, 229: 102.44908615059617, 230: 73.71319955808397, 231: 36.767059653425434, 232: 0, 233: 0, 234: 0}"
73,0,13,20.294314323622167,2,6,19,0.15468015876628693,"[14, 10, 8]",99.11409691346621,3.7299162649474478,13,work_charger,13,19,13,"{13: 99.11409691346621, 14: 95.38418064851876, 15: 84.19443185367642, 16: 65.54485052893918, 17: 39.43543667430705, 18: 5.866190289780022}"
73,0,13,21.1511446501608,3,6,19,0.15468015876628693,"[3, 7, 9]",96.66207513388468,2.028022573897109,13,work_charger,13,19,13,"{13: 96.66207513388468, 14: 94.63405255998758, 15: 88.54998483829625, 16: 78.4098719688107, 17: 64.21371395153093, 18: 45.96151078645696}"
74,13,15,34.84471481601442,3,4,19,0.07509320796132972,"[1, 4, 0]",53.29075229809717,3.420568787211471,15,random,327,331,327,"{327: 53.29075229809717, 328: 49.870183510885695, 329: 39.608477149251286, 330: 22.505633213193928}"
75,5,10,26.86736102733431,2,4,14,0.06532987847272133,"[0, 8, 11]",115.05849866461234,1.8504989974540291,10,commuter,130,134,130,"{130: 115.05849866461234, 131: 113.20799966715832, 132: 107.65650267479623, 133: 98.40400768752608}"
75,4,18,41.90718336059296,3,5,23,0.13834562500105693,"[3, 6, 11]",148.1727217381659,2.644170261683722,18,commuter,114,119,114,"{114: 148.1727217381659, 115: 145.5285514764822, 116: 137.59604069143103, 117: 124.37518938301241, 118: 105.86599755122634}"
75,9,19,29.753168920647408,4,6,24,0.13834562500105693,"[11, 8, 6]",66.76219707554013,4.351029781401357,19,commuter,235,241,235,"{235: 66.76219707554013, 236: 62.41116729413877, 237: 49.358077949934696, 238: 27.60292904292791, 239: 0, 240: 0}"
75,3,19,52.8100496612894,5,6,24,0.13834562500105693,"[11, 8, 14]",114.64305779920032,1.8639411029180133,19,commuter,91,97,91,"{91: 114.64305779920032, 92: 112.7791166962823, 93: 107.18729338752827, 94: 97.8675878729382, 95: 84.82000015251211, 96: 68.04453022624999}"
76,3,19,74.99482279750006,7,9,24,0.15123416284414562,"[6, 13, 9]",138.92381375268258,1.8393063323622454,19,commuter,91,100,91,"{91: 138.92381375268258, 92: 137.08450742032034, 93: 131.56658842323358, 94: 122.37005676142238, 95: 109.49491243488666, 96: 92.94115544362644, 97: 72.70878578764174, 98: 48.79780346693255, 99: 21.208208481498872}"
76,7,8,75.05791210445724,6,9,17,0.126028469036788,"[2, 6, 14]",108.95053841754253,2.3780074205698467,8,commuter,176,185,176,"{176: 108.95053841754253, 177: 106.57253099697269, 178: 99.43850873526314, 179: 87.54847163241391, 180: 70.90241968842498, 181: 49.50035290329637, 182: 23.342271277028047, 183: 0, 184: 0}"
76,10,19,60.6417183996755,3,4,23,0.15123416284414562,"[11, 9, 10]",85.12196306675696,2.2555174939350597,19,commuter,259,263,259,"{259: 85.12196306675696, 260: 82.8664455728219, 261: 76.09989309101672, 262: 64.82230562134143}"
76,4,9,24.305413671038927,2,4,13,0.126028469036788,"[0, 14, 7]",146.93496144198252,1.5612940790713044,9,commuter,105,109,105,"{105: 146.93496144198252, 106: 145.37366736291122, 107: 140.6897851256973, 108: 132.88331473034077}"
76,7,9,68.90269956387206,4,6,15,0.126028469036788,"[2, 3, 10]",133.08372511591529,2.635255560293641,9,commuter,177,183,177,"{177: 133.08372511591529, 178: 130.44846955562164, 179: 122.54270287474073, 180: 109.36642507327252, 181: 90.91963615121702, 182: 67.20233610857426}"
77,6,9,23.660682810143857,3,4,13,0.28271931630175234,"[6, 13, 14]",136.47139628753024,1.2682706061611557,9,random,153,157,153,"{153: 136.47139628753024, 154: 135.20312568136907, 155: 131.39831386288563, 156: 125.05696083207984}"
77,0,17,47.50941211554992,3,5,22,0.3991331524260034,"[8, 14, 5]",98.32486940446245,4.160863046207776,17,random,17,22,17,"{17: 98.32486940446245, 18: 94.16400635825467, 19: 81.68141721963134, 20: 60.87710198859246, 21: 31.751060665138027}"
78,13,18,22.907060431066128,3,6,24,0.1425824067393764,"[1, 8, 3]",131.15470063347328,2.6823622966275766,18,commuter,330,336,330,"{330: 131.15470063347328, 331: 128.4723383368457, 332: 120.42525144696297, 333: 107.01343996382509, 334: 88.23690388743205, 335: 64.09564321778387}"
78,7,9,16.285433015346584,2,3,12,0.13978667327389843,"[11, 1, 10]",102.7299133128794,4.603471577606317,9,commuter,177,180,177,"{177: 102.7299133128794, 178: 98.12644173527309, 179: 84.31602700245413}"
78,6,11,20.321984499668403,2,5,16,0.07921244818854245,"[8, 4, 11]",95.13360327392887,4.834065100010423,11,commuter,155,160,155,"{155: 95.13360327392887, 156: 90.29953817391845, 157: 75.79734287388717, 158: 51.627017373835066, 159: 17.788561673762104}"
78,7,7,38.083101446114426,2,5,12,0.13978667327389843,"[7, 9, 11]",50.3716100271984,2.0423915454871047,7,commuter,175,180,175,"{175: 50.3716100271984, 176: 48.329218481711294, 177: 42.20204384524998, 178: 31.990086117814457, 179: 17.693345299404726}"
79,12,10,51.8713893042727,4,6,16,0.1301684202472836,"[5, 8, 2]",68.68722144034555,3.3062558536904274,10,work_charger,298,304,298,"{298: 68.68722144034555, 299: 65.38096558665512, 300: 55.462198025583845, 301: 38.93091875713171, 302: 15.787127781298715, 303: 0}"
79,2,10,20.159895033052265,2,7,17,0.1531393179379807,"[1, 9, 11]",86.66671778746331,4.911583951144506,10,work_charger,58,65,58,"{58: 86.66671778746331, 59: 81.7551338363188, 60: 67.02038198288528, 61: 42.46246222716276, 62: 8.081374569151222, 63: 0, 64: 0}"
79,12,14,51.923530137666035,6,8,22,0.1301684202472836,"[4, 9, 7]",105.64191311121495,3.0704419096513003,14,work_charger,302,310,302,"{302: 105.64191311121495, 303: 102.57147120156365, 304: 93.36014547260974, 305: 78.00793592435325, 306: 56.51484255679414, 307: 28.880865369932437, 308: 0, 309: 0}"
79,13,17,47.25190178230741,5,10,24,0.23430315644511043,"[5, 6, 14]",80.39008769724683,2.060909981514485,17,work_charger,329,339,329,"{329: 80.39008769724683, 330: 78.32917771573234, 331: 72.14644777118889, 332: 61.84189786361647, 333: 47.41552799301507, 334: 28.8673381593847, 335: 6.197328362725372}"
80,3,9,36.04786224326741,3,4,13,0.113485966982328,"[0, 7, 14]",119.4965268818639,2.2335783678605843,9,commuter,81,85,81,"{81: 119.4965268818639, 82: 117.26294851400331, 83: 110.56221341042156, 84: 99.39432157111864}"
80,1,18,39.8627216799038,3,5,23,0.13618316037879363,"[1, 11, 13]",147.00645370201642,4.706399523086273,18,commuter,42,47,42,"{42: 147.00645370201642, 43: 142.30005417893014, 44: 128.1808556096713, 45: 104.64885799423996, 46: 71.70406133263604}"
80,10,9,30.133365749133798,3,5,14,0.113485966982328,"[8, 5, 12]",95.39327823035617,1.8486450517241169,9,commuter,249,254,249,"{249: 95.39327823035617, 250: 93.54463317863205, 251: 87.99869802345971, 252: 78.75547276483913, 253: 65.8149574027703}"
80,12,11,31.745836891749736,3,6,17,0.0643087146233192,"[5, 3, 1]",133.01389022766534,4.412445556628145,11,commuter,299,305,299,"{299: 133.01389022766534, 300: 128.6014446710372, 301: 115.36410800115276, 302: 93.30188021801203, 303: 62.41476132161502, 304: 22.702751311961705}"
81,3,9,96.4834579868915,7,9,18,0.18321901522480225,"[2, 11, 3]",83.59138451066895,1.5369536763749743,9,commuter,81,90,81,"{81: 83.59138451066895, 82: 82.05443083429397, 83: 77.44356980516905, 84: 69.75880142329417, 85: 59.00012568866936, 86: 45.167542601294585, 87: 28.26105216116987, 88: 8.280654368295203, 89: 0}"
81,6,13,89.02622982423435,5,8,21,0.10382410862738795,"[4, 9, 11]",143.70096995121438,1.899354298871898,13,commuter,157,165,157,"{157: 143.70096995121438, 158: 141.8016156523425, 159: 136.10355275572678, 160: 126.60678126136729, 161: 113.311301169264, 162: 96.21711247941693, 163: 75.32421519182604, 164: 50.632609306491375}"
81,10,7,63.44107675299246,8,10,17,0.18321901522480225,"[4, 14, 2]",101.63398188383266,4.171378135348488,7,commuter,247,257,247,"{247: 101.63398188383266, 248: 97.46260374848417, 249: 84.94846934243871, 250: 64.09157866569626, 251: 34.891931718256856, 252: 0, 253: 0, 254: 0, 255: 0, 256: 0}"
81,13,16,64.84947789008498,5,6,22,0.10382410862738795,"[0, 12, 9]",90.40201028628135,1.064678159818079,16,commuter,328,334,328,"{328: 90.40201028628135, 329: 89.33733212646328, 330: 86.14329764700904, 331: 80.81990684791865, 332: 73.36715972919208, 333: 63.785056290829374}"
82,12,15,46.53178506800573,7,12,24,0.18649870830860968,"[4, 6, 14]",83.30732960529416,3.2608472798289525,15,weekend_user,303,315,303,"{303: 83.30732960529416, 304: 80.0464823254652, 305: 70.26394048597835, 306: 53.95970408683358, 307: 31.133773128030917, 308: 1.7861476095703495, 309: 0, 310: 0, 311: 0, 312: 0, 313: 0, 314: 0}"
82,13,12,75.10786979399519,5,10,22,0.18649870830860968,"[1, 13, 9]",111.67380805749028,3.503600931695969,12,weekend_user,324,334,324,"{324: 111.67380805749028, 325: 108.1702071257943, 326: 97.6594043307064, 327: 80.14139967222656, 328: 55.616193150354775, 329: 24.083784765091053, 330: 0, 331: 0, 332: 0, 333: 0}"
83,13,20,66.46498972969849,8,12,24,0.14454158796234107,"[4, 7, 0]",123.35583529355067,2.6708087067144226,20,night_charger,332,344,332,"{332: 123.35583529355067, 333: 120.68502658683624, 334: 112.67260046669298, 335: 99.31855693312087}"
83,4,21,67.70013737008846,5,10,24,0.09447162611917718,"[13, 9, 11]",74.87071559664679,3.712730338356272,21,night_charger,117,127,117,"{117: 74.87071559664679, 118: 71.15798525829052, 119: 60.0197942432217, 120: 41.456142551440344, 121: 15.467030182946438, 122: 0, 123: 0, 124: 0, 125: 0, 126: 0}"
83,2,21,26.991480543060128,3,11,24,0.09447162611917718,"[13, 4, 2]",115.95303190299806,3.19052260552071,21,night_charger,69,80,69,"{69: 115.95303190299806, 70: 112.76250929747735, 71: 103.19094148091523, 72: 87.23832845331168, 73: 64.90467021466671, 74: 36.18996676498031, 75: 1.094218104252505, 76: 0, 77: 0, 78: 0, 79: 0}"
84,12,18,22.272821535646543,2,4,22,0.23310927813957338,"[1, 12, 14]",125.659393401413,4.289689240065109,18,commuter,306,310,306,"{306: 125.659393401413, 307: 121.36970416134788, 308: 108.50063644115257, 309: 87.05219024082702}"
84,2,17,27.57637487577657,2,5,22,0.27424620957596874,"[14, 11, 13]",113.86990948831726,2.5506396022351963,17,commuter,65,70,65,"{65: 113.86990948831726, 66: 111.31926988608207, 67: 103.66735107937647, 68: 90.91415306820049, 69: 73.05967585255412}"
84,9,18,47.684969412229925,4,7,24,0.27424620957596874,"[8, 6, 13]",95.1164003687596,3.4145780980239513,18,commuter,234,241,234,"{234: 95.1164003687596, 235: 91.70182227073565, 236: 81.45808797666379, 237: 64.38519748654403, 238: 40.48315080037638, 239: 9.751947918160823, 240: 0}"
84,0,18,9.445185440489446,2,5,23,0.27424620957596874,"[0, 4, 14]",114.92427328379706,1.326815838408915,18,commuter,18,23,18,"{18: 114.92427328379706, 19: 113.59745744538814, 20: 109.6170099301614, 21: 102.98293073811683, 22: 93.69521986925443}"
84,3,19,43.96903686738014,3,6,24,0.27424620957596874,"[7, 1, 0]",97.90237316091739,3.3971663288805654,19,commuter,91,97,91,"{91: 97.90237316091739, 92: 94.50520683203683, 93: 84.31370784539513, 94: 67.3278762009923, 95: 43.54771189882835, 96: 12.973214938903254}"
85,5,12,48.59191139829593,4,7,19,0.06389000742430898,"[6, 2, 0]",66.48567409465501,1.6957912064167728,12,commuter,132,139,132,"{132: 66.48567409465501, 133: 64.78988288823824, 134: 59.70250926898792, 135: 51.22355323690405, 136: 39.353014791986645, 137: 24.090893934235687, 138: 5.437190663651187}"
85,8,7,31.26063007829609,2,3,10,0.11274707192525112,"[0, 2, 9]",58.52582246368606,1.9788073805986341,7,commuter,199,202,199,"{199: 58.52582246368606, 200: 56.54701508308743, 201: 50.61059294129153}"
85,7,8,57.94883024408365,6,7,15,0.11274707192525112,"[14, 11, 12]",100.52553902509104,1.989378684573376,8,commuter,176,183,176,"{176: 100.52553902509104, 177: 98.53616034051765, 178: 92.56802428679754, 179: 82.62113086393066, 180: 68.69548007191702, 181: 50.791071910756635, 182: 28.907906380449504}"
86,2,9,54.82790147873563,5,7,16,0.11423211951804248,"[12, 6, 2]",57.18075454454692,1.3771039115957442,9,commuter,57,64,57,"{57: 57.18075454454692, 58: 55.803650632951175, 59: 51.67233889816394, 60: 44.786819340185225, 61: 35.147091959015015, 62: 22.753156754653318, 63: 7.605013727100129}"
86,5,18,56.225164715946846,8,10,24,0.11651676190840334,"[10, 11, 3]",138.31656779756176,1.6681606544800736,18,commuter,138,148,138,"{138: 138.31656779756176, 139: 136.6484071430817, 140: 131.64392517964146, 141: 123.30312190724109, 142: 111.62599732588058, 143: 96.61255143555992, 144: 78.26278423627912, 145: 56.57669572803816, 146: 31.554285910837052, 147: 3.1955547846758066}"
86,13,12,31.325245455673596,4,7,19,0.06473153439355742,"[6, 13, 10]",125.16163936462769,1.8560001977444593,12,commuter,324,331,324,"{324: 125.16163936462769, 325: 123.30563916688322, 326: 117.73763857364985, 327: 108.45763758492755, 328: 95.46563620071635, 329: 78.7616344210162, 330: 58.34563224582715}"
86,11,18,58.28477212719455,3,4,22,0.137078543421651,"[11, 3, 4]",63.97406595643543,2.5606828610868924,18,commuter,282,286,282,"{282: 63.97406595643543, 283: 61.413383095348536, 284: 53.73133451208786, 285: 40.9279202066534}"
87,2,21,23.137624599279285,2,8,24,0.10106447662286926,"[3, 11, 7]",54.99827150775518,3.4395749666771973,21,night_charger,69,77,69,"{69: 54.99827150775518, 70: 51.55869654107798, 71: 41.23997164104639, 72: 24.0420968076604, 73: 0, 74: 0, 75: 0, 76: 0}"
87,5,20,52.100127768961485,4,9,24,0.15462864923298997,"[2, 1, 11]",121.18820852292892,1.2337239634183006,20,night_charger,140,149,140,"{140: 121.18820852292892, 141: 119.95448455951062, 142: 116.25331266925572, 143: 110.08469285216421, 144: 101.44862510823612, 145: 90.34510943747141, 146: 76.7741458398701, 147: 60.73573431543219, 148: 42.22987486415768}"
87,8,23,58.50883906745974,3,10,24,0.07074513363600848,"[2, 3, 5]",71.8076782061153,2.5653462507486346,23,night_charger,215,225,215,"{215: 71.8076782061153, 216: 69.24233195536667, 217: 61.54629320312076, 218: 48.719561949377585, 219: 30.762138194137144, 220: 7.674021937399431, 221: 0, 222: 0, 223: 0, 224: 0}"
88,6,11,28.58202852248663,2,4,15,0.18352197934942222,"[7, 3, 9]",142.317602845633,3.992357462812506,11,commuter,155,159,155,"{155: 142.317602845633, 156: 138.3252453828205, 157: 126.34817299438296, 158: 106.38638568032044}"
88,7,18,13.10685785304977,1,3,21,0.3886347797987765,"[8, 1, 4]",51.9435155182302,1.4428227552260435,18,commuter,186,189,186,"{186: 51.9435155182302, 187: 50.50069276300415, 188: 46.17222449732603}"
88,8,17,23.623950902566047,2,3,20,0.3886347797987765,"[9, 12, 5]",137.45764767182007,1.853386298240506,17,commuter,209,212,209,"{209: 137.45764767182007, 210: 135.60426137357956, 211: 130.04410247885804}"
88,7,17,14.165744579014753,1,4,21,0.3886347797987765,"[9, 14, 4]",85.91639386339531,3.8708134468373476,17,commuter,185,189,185,"{185: 85.91639386339531, 186: 82.04558041655797, 187: 70.43314007604593, 188: 51.07907284185919}"
88,10,17,38.907508021739886,4,7,24,0.3886347797987765,"[2, 11, 8]",70.63388785820888,1.5802615785616942,17,commuter,257,264,257,"{257: 70.63388785820888, 258: 69.05362627964719, 259: 64.31284154396211, 260: 56.41153365115363, 261: 45.34970260122177, 262: 31.127348394166525, 263: 13.744471029987885}"
89,4,10,53.00549799885971,4,7,17,0.09802054075438722,"[6, 4, 3]",129.1573908930028,4.821656658984386,10,random,106,113,106,"{106: 129.1573908930028, 107: 124.33573423401842, 108: 109.87076425706525, 109: 85.76248096214331, 110: 52.01088434925262, 111: 8.61597441839315, 112: 0}"
89,0,19,24.34025170206658,2,3,22,0.17643697335789701,"[4, 6, 3]",93.07053316984052,2.8933835237104732,19,random,19,22,19,"{19: 93.07053316984052, 20: 90.17714964613005, 21: 81.49699907499863}"
90,6,16,65.42261179654525,4,9,24,0.19936025538282232,"[7, 9, 4]",109.2486404631925,2.1911482929171955,16,weekend_user,160,169,160,"{160: 109.2486404631925, 161: 107.05749217027531, 162: 100.48404729152372, 163: 89.52830582693774, 164: 74.19026777651737, 165: 54.46993314026261, 166: 30.367301918173467, 167: 1.882374110249927, 168: 0}"
90,5,13,36.880734157093656,2,7,20,0.19936025538282232,"[11, 14, 6]",101.26839534499427,1.5873926762937045,13,weekend_user,133,140,133,"{133: 101.26839534499427, 134: 99.68100266870057, 135: 94.91882463981946, 136: 86.98186125835093, 137: 75.870112524295, 138: 61.58357843765166, 139: 44.12225899842091}"
91,0,8,49.43293661366141,7,9,17,0.4135677889379999,"[9, 2, 14]",57.8049528399892,3.5014256065345646,8,commuter,8,17,8,"{8: 57.8049528399892, 9: 54.30352723345463, 10: 43.79925041385094, 11: 26.292122381178118, 12: 1.782143135436165, 13: 0, 14: 0, 15: 0, 16: 0}"
91,11,19,31.506665380191244,3,6,24,0.4962813467255999,"[7, 8, 4]",139.1867983751081,4.884697620559833,19,commuter,283,289,283,"{283: 139.1867983751081, 284: 134.3021007545483, 285: 119.64800789286878, 286: 95.22451979006962, 287: 61.031636446150785, 288: 17.069357861112294}"
91,2,7,40.068238502288224,3,5,12,0.4135677889379999,"[3, 6, 13]",102.75145198885448,2.3368611734830393,7,commuter,55,60,55,"{55: 102.75145198885448, 56: 100.41459081537144, 57: 93.40400729492232, 58: 81.71970142750713, 59: 65.36167321312585}"
91,5,16,24.55734837810273,2,5,21,0.23435508039819994,"[10, 12, 13]",147.2578417659476,4.124467384836056,16,commuter,136,141,136,"{136: 147.2578417659476, 137: 143.13337438111154, 138: 130.7599722266034, 139: 110.1376353024231, 140: 81.26636360857071}"
91,10,7,58.6711262440073,5,8,15,0.4135677889379999,"[13, 6, 1]",145.8348583630942,2.7400477097499008,7,commuter,247,255,247,"{247: 145.8348583630942, 248: 143.09481065334433, 249: 134.8746675240946, 250: 121.17442897534511, 251: 101.99409500709581, 252: 77.33366561934669, 253: 47.19314081209778, 254: 11.572520585349082}"
92,3,11,39.30798283041943,3,6,17,0.08648336152532428,"[2, 11, 7]",98.85611605848416,1.4557527325119413,11,work_charger,83,89,83,"{83: 98.85611605848416, 84: 97.40036332597222, 85: 93.0331051284364, 86: 85.75434146587669, 87: 75.5640723382931, 88: 62.46229774568563}"
92,9,9,39.68552305777215,5,7,16,0.1297250422879864,"[9, 7, 1]",147.8456672184284,2.50016279296084,9,work_charger,225,232,225,"{225: 147.8456672184284, 226: 145.34550442546754, 227: 137.84501604658502, 228: 125.34420208178082, 229: 107.84306253105495, 230: 85.34159739440739, 231: 57.83980667183815}"
92,1,11,34.569865816514636,3,8,19,0.08648336152532428,"[5, 4, 1]",136.06888505739894,1.5865232601103263,11,work_charger,35,43,35,"{35: 136.06888505739894, 36: 134.4823617972886, 37: 129.72279201695764, 38: 121.79017571640601, 39: 110.68451289563373, 40: 96.40580355464078, 41: 78.9540476934272, 42: 58.32924531199295}"
93,12,13,29.52604189435646,2,8,21,0.1565128838106978,"[13, 7, 14]",149.61468309333384,1.4661784399945303,13,weekend_user,301,309,301,"{301: 149.61468309333384, 302: 148.1485046533393, 303: 143.74996933335572, 304: 136.41907713338307, 305: 126.15582805342135, 306: 112.96022209347058, 307: 96.83225925353074, 308: 77.77193953360185}"
94,9,19,62.54331278539591,5,8,24,0.25268106558453884,"[1, 9, 13]",71.34615161389688,2.7055595790777005,19,commuter,235,243,235,"{235: 71.34615161389688, 236: 68.64059203481918, 237: 60.52391329758608, 238: 46.996115402197574, 239: 28.05719834865367, 240: 3.7071621369543664, 241: 0, 242: 0}"
94,1,19,42.50892197978423,3,6,24,0.25268106558453884,"[6, 9, 13]",129.11141182014396,3.2133346896910817,19,commuter,43,49,43,"{43: 129.11141182014396, 44: 125.89807713045288, 45: 116.25807306137963, 46: 100.19139961292422, 47: 77.69805678508665, 48: 48.77804457786691}"
94,10,8,19.624213840701366,3,5,13,0.21056755465378235,"[9, 13, 11]",129.70768065627564,3.726702593436294,8,commuter,248,253,248,"{248: 129.70768065627564, 249: 125.98097806283934, 250: 114.80087028253047, 251: 96.167357315349, 252: 70.08043916129495}"
94,11,9,29.72698934303495,2,5,14,0.21056755465378235,"[10, 0, 2]",81.18901498044245,2.7749531096446574,9,commuter,273,278,273,"{273: 81.18901498044245, 274: 78.4140618707978, 275: 70.08920254186383, 276: 56.21443699364053, 277: 36.78976522612793}"
95,9,8,25.927448884723315,2,7,15,0.11478502052732531,"[8, 7, 14]",54.980028289437676,1.7225087046463097,8,work_charger,224,231,224,"{224: 54.980028289437676, 225: 53.25751958479137, 226: 48.089993470852434, 227: 39.47744994762089, 228: 27.41988901509672, 229: 11.917310673279935, 230: 0}"
95,3,13,26.836193827846834,2,5,18,0.07652334701821688,"[9, 4, 8]",142.62141053985687,4.260031107935031,13,work_charger,85,90,85,"{85: 142.62141053985687, 86: 138.36137943192185, 87: 125.58128610811674, 88: 104.28113056844158, 89: 74.46091281289637}"
95,11,12,16.115358461174033,1,4,16,0.07652334701821688,"[2, 9, 1]",79.32660857428303,4.684633975736467,12,work_charger,276,280,276,"{276: 79.32660857428303, 277: 74.64197459854657, 278: 60.58807267133716, 279: 37.16490279265483}"
96,3,13,62.09311032385082,3,4,17,0.1492150166844206,"[3, 6, 12]",104.32109871388043,4.329332562534333,13,random,85,89,85,"{85: 104.32109871388043, 86: 99.9917661513461, 87: 87.0037684637431, 88: 65.35710565107144}"
96,13,9,46.120858725012624,3,4,13,0.19024914627263625,"[14, 11, 13]",86.64566463399797,1.1728547981999933,9,random,321,325,321,"{321: 86.64566463399797, 322: 85.47280983579797, 323: 81.954245441198, 324: 76.08997145019802}"
96,6,8,60.439732922877965,7,9,17,0.19024914627263625,"[11, 14, 3]",68.1247806066155,3.2621556584786404,8,random,152,161,152,"{152: 68.1247806066155, 153: 64.86262494813687, 154: 55.07615797270094, 155: 38.76537968030774, 156: 15.930290070957255, 157: 0, 158: 0, 159: 0, 160: 0}"
97,13,20,61.06825346187371,3,6,24,0.2429253491166734,"[11, 14, 5]",74.6516324409715,3.2544663423932003,20,weekend_user,332,338,332,"{332: 74.6516324409715, 333: 71.3971660985783, 334: 61.633767071398694, 335: 45.36143535943269}"
98,9,8,34.098659273468726,3,5,13,0.11985221426583159,"[8, 6, 13]",61.25545073655157,3.718962231425483,8,random,224,229,224,"{224: 61.25545073655157, 225: 57.53648850512609, 226: 46.37960181084964, 227: 27.784790653722226, 228: 1.7520550337438436}"
98,4,7,36.201987191287266,3,6,13,0.11985221426583159,"[3, 2, 10]",103.73348248430777,2.7765768088804785,7,random,103,109,103,"{103: 103.73348248430777, 104: 100.9569056754273, 105: 92.62717524878586, 106: 78.74429120438347, 107: 59.308253542220115, 108: 34.3190622622958}"
98,0,10,53.60884211708677,3,7,17,0.07990147617722107,"[6, 13, 4]",133.44228458443445,1.6008595818677032,10,random,10,17,10,"{10: 133.44228458443445, 11: 131.84142500256675, 12: 127.03884625696364, 13: 119.03454834762512, 14: 107.8285312745512, 15: 93.42079503774187, 16: 75.81133963719714}"
99,13,23,32.48090552323257,2,9,24,0.1339843309504205,"[9, 4, 2]",87.11922361459939,3.820080139475247,23,night_charger,335,344,335,{335: 87.11922361459939}
99,11,21,39.07381819338086,3,10,24,0.22518374949650505,"[2, 11, 14]",73.30940708620564,4.092594403325959,21,night_charger,285,295,285,"{285: 73.30940708620564, 286: 69.21681268287968, 287: 56.9390294729018, 288: 36.476057456272, 289: 7.827896632990289, 290: 0, 291: 0, 292: 0, 293: 0, 294: 0}"
99,5,21,61.198326043501,5,12,24,0.1914061870720293,"[11, 6, 13]",68.10628991159643,3.17694703044167,21,night_charger,141,153,141,"{141: 68.10628991159643, 142: 64.92934288115477, 143: 55.39850178982975, 144: 39.5137666376214, 145: 17.275137424529717, 146: 0, 147: 0, 148: 0, 149: 0, 150: 0, 151: 0, 152: 0}"
100,1,8,36.357037358327005,2,6,14,0.13724754254776791,"[2, 13, 4]",132.358982417063,2.432966600147936,8,random,32,38,32,"{32: 132.358982417063, 33: 129.92601581691505, 34: 122.62711601647126, 35: 110.46228301573157, 36: 93.43151681469602, 37: 71.5348174133646}"
101,12,15,38.21233350404826,3,7,22,0.06432576869928805,"[2, 4, 1]",60.63058213129514,4.626969490290215,15,work_charger,303,310,303,"{303: 60.63058213129514, 304: 56.00361264100493, 305: 42.122704170134284, 306: 18.987856718683204, 307: 0, 308: 0, 309: 0}"
101,7,9,28.25744069931474,3,6,15,0.11351606241050831,"[11, 5, 7]",133.55951636077305,1.0727983686042109,9,work_charger,177,183,177,"{177: 133.55951636077305, 178: 132.48671799216885, 179: 129.2683228863562, 180: 123.90433104333515, 181: 116.39474246310567, 182: 106.73955714566777}"
101,2,12,11.065656906419765,2,4,16,0.07567737494033888,"[0, 4, 7]",122.87106850897787,3.267596940127271,12,work_charger,60,64,60,"{60: 122.87106850897787, 61: 119.6034715688506, 62: 109.80068074846879, 63: 93.46269604783244}"
101,13,13,47.76845711816409,3,7,20,0.06432576869928805,"[0, 7, 1]",52.23467884268573,1.6860519905920888,13,work_charger,325,332,325,"{325: 52.23467884268573, 326: 50.54862685209364, 327: 45.490470880317375, 328: 37.060210927356934, 329: 25.25784699321231, 330: 10.083379077883514, 331: 0}"
102,7,22,71.50611116537905,8,12,24,0.08099596893369633,"[6, 9, 0]",76.32214028671348,3.8410913942769986,22,night_charger,190,202,190,"{190: 76.32214028671348, 191: 72.48104889243648, 192: 60.95777470960548, 193: 41.75231773822049, 194: 14.864677978281499, 195: 0, 196: 0, 197: 0, 198: 0, 199: 0, 200: 0, 201: 0}"
102,3,23,42.0187879547597,4,9,24,0.05669717825358743,"[4, 6, 1]",61.22727583289096,3.9069622609172785,23,night_charger,95,104,95,"{95: 61.22727583289096, 96: 57.320313571973685, 97: 45.599426789221845, 98: 26.064615484635453, 99: 0, 100: 0, 101: 0, 102: 0, 103: 0}"
102,9,19,64.45075770821265,6,12,24,0.1457927440806534,"[11, 4, 0]",50.18727439191686,2.4025971318160746,19,night_charger,235,247,235,"{235: 50.18727439191686, 236: 47.784677260100786, 237: 40.57688586465256, 238: 28.56390020557219, 239: 11.745720282859665, 240: 0, 241: 0, 242: 0, 243: 0, 244: 0, 245: 0, 246: 0}"
103,5,8,91.88117152201241,8,11,19,0.1294414598316201,"[1, 5, 7]",104.34894577086338,1.396225736863952,8,random,128,139,128,"{128: 104.34894577086338, 129: 102.95272003399943, 130: 98.76404282340758, 131: 91.78291413908781, 132: 82.00933398104016, 133: 69.44330234926458, 134: 54.08481924376111, 135: 35.93388466452974, 136: 14.990498611570459, 137: 0, 138: 0}"
103,4,19,14.617550038321745,1,3,22,0.18274088446816955,"[1, 6, 9]",103.21198602047065,2.736946786445583,19,random,115,118,115,"{115: 103.21198602047065, 116: 100.47503923402506, 117: 92.26419887468832}"
104,12,17,35.54172457869264,3,7,24,0.2363320785679729,"[5, 4, 6]",59.32139258926985,1.18372012891636,17,work_charger,305,312,305,"{305: 59.32139258926985, 306: 58.137672460353485, 307: 54.58651207360441, 308: 48.66791142902261, 309: 40.38187052660809, 310: 29.72838936636085, 311: 16.707467948280893}"
104,0,9,60.15109085988579,3,5,14,0.23169811624311068,"[12, 3, 13]",145.49079089350033,4.835618419380821,9,work_charger,9,14,9,"{9: 145.49079089350033, 10: 140.65517247411952, 11: 126.14831721597704, 12: 101.97022511907295, 13: 68.1208961834072}"
104,10,10,36.29089487300093,3,6,16,0.15446541082874046,"[1, 4, 14]",65.31025047988,3.97040528613036,10,work_charger,250,256,250,"{250: 65.31025047988, 251: 61.33984519374964, 252: 49.42862933535856, 253: 29.57660290470676, 254: 1.78376590179424, 255: 0}"
105,6,10,39.426485465929964,5,8,18,0.14464261260129369,"[12, 7, 13]",112.80834765714354,4.361344952884332,10,commuter,154,162,154,"{154: 112.80834765714354, 155: 108.4470027042592, 156: 95.36296784560622, 157: 73.55624308118456, 158: 43.02682841099423, 159: 3.774723835035232, 160: 0, 161: 0}"
105,6,13,28.80572041579117,3,5,18,0.14464261260129369,"[1, 7, 4]",116.5077439998428,4.358517550275968,13,commuter,157,162,157,"{157: 116.5077439998428, 158: 112.14922644956684, 159: 99.07367379873892, 160: 77.28108604735908, 161: 46.771463195427316}"
105,0,18,49.38460173053632,3,4,22,0.3063020031556808,"[6, 3, 11]",60.94304048359793,2.0818764224660353,18,commuter,18,22,18,"{18: 60.94304048359793, 19: 58.861164061131895, 20: 52.615534793733794, 21: 42.206152681403616}"
106,4,18,21.131973968774606,2,3,21,0.15617022870744537,"[4, 6, 11]",143.79109534243435,3.116980227837892,18,commuter,114,117,114,"{114: 143.79109534243435, 115: 140.67411511459645, 116: 131.32317443108278}"
106,13,10,36.39496645406524,3,4,14,0.07374705244518252,"[10, 5, 3]",108.07610919522531,2.934721783031466,10,commuter,322,326,322,"{322: 108.07610919522531, 323: 105.14138741219385, 324: 96.33722206309945, 325: 81.66361314794212}"
106,3,9,28.896661567519594,3,5,14,0.13014185725620445,"[11, 9, 14]",52.14398666231133,3.9546106023525684,9,commuter,81,86,81,"{81: 52.14398666231133, 82: 48.18937605995876, 83: 36.325544252901054, 84: 16.552491241138213, 85: 0}"
106,11,18,25.1769648524772,3,4,22,0.15617022870744537,"[2, 6, 12]",143.23056827448798,3.4049442318356204,18,commuter,282,286,282,"{282: 143.23056827448798, 283: 139.82562404265235, 284: 129.6107913471455, 285: 112.5860701879674}"
107,13,15,14.557499808640738,1,3,18,0.07006522882394903,"[11, 0, 9]",124.74929558814,2.778500960246171,15,commuter,327,330,327,"{327: 124.74929558814, 328: 121.97079462789382, 329: 113.63529174715532}"
107,2,19,31.632900846952282,4,5,24,0.14837342574483325,"[3, 14, 11]",84.96533804622376,1.371380346122482,19,commuter,67,72,67,"{67: 84.96533804622376, 68: 83.59395770010129, 69: 79.47981666173384, 70: 72.62291493112143, 71: 63.02325250826405}"
107,8,18,23.605973010412086,3,5,23,0.14837342574483325,"[14, 9, 4]",95.95870058794439,1.7462316487824627,18,commuter,210,215,210,"{210: 95.95870058794439, 211: 94.21246893916192, 212: 88.97377399281454, 213: 80.24261574890222, 214: 68.01899420742498}"
108,13,19,32.36561950799463,4,6,24,0.17816215344966652,"[2, 6, 11]",118.33886331434175,2.121841947407381,19,commuter,331,337,331,"{331: 118.33886331434175, 332: 116.21702136693438, 333: 109.85149552471222, 334: 99.24228578767531, 335: 84.38939215582366}"
108,10,7,15.824585944172217,2,5,12,0.1746687778918299,"[4, 14, 2]",81.12452525785969,3.039570302923487,7,commuter,247,252,247,"{247: 81.12452525785969, 248: 78.0849549549362, 249: 68.96624404616574, 250: 53.7683925315483, 251: 32.491400411083895}"
108,0,7,17.161326078860164,1,2,9,0.1746687778918299,"[13, 4, 3]",88.430018756052,1.2213679942018114,7,commuter,7,9,7,"{7: 88.430018756052, 8: 87.20865076185018}"
109,7,8,17.23158621350222,2,4,12,0.2596623501901744,"[9, 6, 13]",135.42203429657326,1.4096024638515958,8,commuter,176,180,176,"{176: 135.42203429657326, 177: 134.01243183272166, 178: 129.78362444116686, 179: 122.7356121219089}"
109,8,8,34.160148661675436,2,5,13,0.2596623501901744,"[4, 5, 6]",87.2337818385381,2.2731061844779217,8,commuter,200,205,200,"{200: 87.2337818385381, 201: 84.96067565406018, 202: 78.14135710062642, 203: 66.77582617823681, 204: 50.86408288689136}"
109,12,17,35.124830299831864,2,3,20,0.2648555971939779,"[8, 11, 6]",135.70971895598575,1.9305259456385535,17,commuter,305,308,305,"{305: 135.70971895598575, 306: 133.7791930103472, 307: 127.98761517343154}"
110,12,10,33.08257431708522,2,7,17,0.19046486214070932,"[11, 1, 2]",123.32048049529766,2.7254618255520078,10,weekend_user,298,305,298,"{298: 123.32048049529766, 299: 120.59501866974566, 300: 112.41863319308963, 301: 98.79132406532959, 302: 79.71309128646553, 303: 55.18393485649746, 304: 25.203854775425384}"
111,10,7,53.603750195735465,5,8,15,0.3567073334851573,"[4, 13, 1]",67.66136925741229,3.1948784223321978,7,commuter,247,255,247,"{247: 67.66136925741229, 248: 64.4664908350801, 249: 54.881855568083495, 250: 38.907463456422505, 251: 16.543314500097125, 252: 0, 253: 0, 254: 0}"
111,1,17,48.30213516599545,4,7,24,0.4280488001821889,"[10, 7, 8]",76.65501204542869,2.379495134772839,17,commuter,41,48,41,"{41: 76.65501204542869, 42: 74.27551691065585, 43: 67.13703150633734, 44: 55.239555832473144, 45: 38.58308988906327, 46: 17.167633676107712, 47: 0}"
111,0,18,43.20658014273842,3,4,22,0.4280488001821889,"[10, 3, 1]",122.62864640181202,3.044210671178306,18,commuter,18,22,18,"{18: 122.62864640181202, 19: 119.58443573063371, 20: 110.4518037170988, 21: 95.23075036120727}"
112,9,19,34.756032821657705,2,9,24,0.17103587620269917,"[6, 11, 12]",88.39601263173785,4.08359361727521,19,night_charger,235,244,235,"{235: 88.39601263173785, 236: 84.31241901446263, 237: 72.06163816263701, 238: 51.64367007626095, 239: 23.058514755334485, 240: 0, 241: 0, 242: 0, 243: 0}"
112,11,20,44.24839879903011,3,11,24,0.17103587620269917,"[14, 6, 8]",89.13328364661928,4.839712482334006,20,night_charger,284,295,284,"{284: 89.13328364661928, 285: 84.29357116428527, 286: 69.77443371728324, 287: 45.57587130561322, 288: 11.697883929275179, 289: 0, 290: 0, 291: 0, 292: 0, 293: 0, 294: 0}"
113,7,18,21.56620821527504,2,3,21,0.23890040159667847,"[5, 11, 13]",125.49317330722383,1.9085054623674624,18,commuter,186,189,186,"{186: 125.49317330722383, 187: 123.58466784485637, 188: 117.85915145775398}"
113,7,17,45.75730700954871,5,8,24,0.23890040159667847,"[8, 13, 2]",92.06822370409284,4.331372371467349,17,commuter,185,193,185,"{185: 92.06822370409284, 186: 87.73685133262549, 187: 74.74273421822345, 188: 53.0858723608867, 189: 22.766265760615255, 190: 0, 191: 0, 192: 0}"
113,6,17,35.63076344425837,2,5,22,0.2030653413571767,"[0, 11, 4]",84.69670756244838,1.8335408130258073,17,commuter,161,166,161,"{161: 84.69670756244838, 162: 82.86316674942258, 163: 77.36254431034516, 164: 68.19484024521611, 165: 55.360054554035464}"
113,11,18,5.977381510079262,1,2,20,0.23890040159667847,"[4, 6, 0]",59.193793592083765,3.7437168828328784,18,commuter,282,284,282,"{282: 59.193793592083765, 283: 55.45007670925089}"
113,5,11,53.62178276366663,3,6,17,0.11281407853176484,"[0, 9, 1]",128.09331797904943,4.966030753114008,11,commuter,131,137,131,"{131: 128.09331797904943, 132: 123.12728722593542, 133: 108.2291949665934, 134: 83.39904120102335, 135: 48.636825929225296, 136: 3.9425491511992163}"
114,13,12,37.227752127960756,2,4,16,0.06862070404335298,"[10, 12, 0]",90.43300593475422,4.138940456344397,12,work_charger,324,328,324,"{324: 90.43300593475422, 325: 86.29406547840982, 326: 73.87724410937663, 327: 53.182541827654646}"
114,7,12,20.787372963832297,1,5,17,0.0807302400510035,"[4, 9, 3]",55.59802848616864,1.4840628669945954,12,work_charger,180,185,180,"{180: 55.59802848616864, 181: 54.11396561917404, 182: 49.66177701819026, 183: 42.24146268321728, 184: 31.85302261425511}"
114,12,11,62.17437184751303,6,11,22,0.06862070404335298,"[3, 12, 2]",70.66120806809758,3.035363392522027,11,work_charger,299,310,299,"{299: 70.66120806809758, 300: 67.62584467557555, 301: 58.51975449800947, 302: 43.34293753539934, 303: 22.095393787745145, 304: 0, 305: 0, 306: 0, 307: 0, 308: 0, 309: 0}"
115,13,11,58.100863541632116,3,9,20,0.07921680606203171,"[2, 4, 1]",135.74148466508007,3.2331060976156634,11,weekend_user,323,332,323,"{323: 135.74148466508007, 324: 132.5083785674644, 325: 122.80906027461741, 326: 106.64352978653909, 327: 84.01178710322945, 328: 54.91383222468848, 329: 19.34966515091618, 330: 0, 331: 0}"
116,9,10,38.43437724171513,5,6,16,0.1906236964548603,"[7, 3, 14]",148.41396470417362,1.7481707409548575,10,random,226,232,226,"{226: 148.41396470417362, 227: 146.66579396321876, 228: 141.4212817403542, 229: 132.6804280355799, 230: 120.4432328488959, 231: 104.70969618030219}"
116,0,8,14.13956362262265,2,3,11,0.28593554468229043,"[13, 6, 8]",137.38197762800525,1.2106933273187885,8,random,8,11,8,"{8: 137.38197762800525, 9: 136.17128430068647, 10: 132.5392043187301}"
116,0,15,41.84525222763323,3,6,21,0.1906236964548603,"[14, 13, 6]",61.153334035167646,3.816619003155495,15,random,15,21,15,"{15: 61.153334035167646, 16: 57.33671503201215, 17: 45.88685802254567, 18: 26.803763006768186, 19: 0.08742998467972285, 20: 0}"
117,5,18,37.13140060681783,5,7,24,0.1615439373408409,"[2, 11, 1]",101.47673740754429,1.2555031354475537,18,work_charger,138,145,138,"{138: 101.47673740754429, 139: 100.22123427209674, 140: 96.45472486575407, 141: 90.17720918851631, 142: 81.38868724038343, 143: 70.08915902135544, 144: 56.27862453143236}"
117,4,13,80.60899034246613,7,11,24,0.10558427277179146,"[14, 3, 13]",89.59111507626835,3.873393298082971,13,work_charger,109,120,109,"{109: 89.59111507626835, 110: 85.71772177818538, 111: 74.09754188393647, 112: 54.73057539352161, 113: 27.61682230694082, 114: 0, 115: 0, 116: 0, 117: 0, 118: 0, 119: 0}"
117,6,12,96.54322114613399,7,11,23,0.08974663185602275,"[9, 1, 14]",90.04164611708273,3.5530039415879555,12,work_charger,156,167,156,"{156: 90.04164611708273, 157: 86.48864217549477, 158: 75.82963035073091, 159: 58.06461064279114, 160: 33.193583051675446, 161: 1.2165475773838494, 162: 0, 163: 0, 164: 0, 165: 0, 166: 0}"
118,13,11,34.033894296814786,2,5,16,0.11055633685027502,"[0, 13, 12]",147.2583032551332,1.232951130842713,11,commuter,323,328,323,"{323: 147.2583032551332, 324: 146.0253521242905, 325: 142.32649873176234, 326: 136.16174307754878, 327: 127.5310851616498}"
118,0,18,23.563622024944586,2,3,21,0.2341193015652883,"[0, 13, 2]",69.84007292457164,2.8898413154157905,18,commuter,18,21,18,"{18: 69.84007292457164, 19: 66.95023160915585, 20: 58.28070766290848}"
118,0,9,48.88239313851187,3,5,14,0.19509941797107355,"[4, 12, 10]",149.01652122554054,4.999266877450712,9,commuter,9,14,9,"{9: 149.01652122554054, 10: 144.01725434808984, 11: 129.0194537157377, 12: 104.02311932848414, 13: 69.02825118632916}"
119,11,8,19.63107370578659,3,5,13,0.1647296176630915,"[4, 2, 0]",64.08996380731261,4.414225454482653,8,work_charger,272,277,272,"{272: 64.08996380731261, 273: 59.67573835282996, 274: 46.433061989382, 275: 24.361934716968733, 276: 0}"
119,3,13,32.70854609723234,2,7,20,0.10981974510872768,"[0, 12, 14]",68.14871248586986,1.481531859098479,13,work_charger,85,92,85,"{85: 68.14871248586986, 86: 66.66718062677138, 87: 62.22258504947595, 88: 54.81492575398356, 89: 44.4442027402942, 90: 31.11041600840789, 91: 14.813565558324626}"
119,4,11,33.548316943079556,2,6,17,0.10981974510872768,"[9, 2, 1]",117.40229466016328,1.4176897846356327,11,work_charger,107,113,107,"{107: 117.40229466016328, 108: 115.98460487552765, 109: 111.73153552162074, 110: 104.64308659844258, 111: 94.71925810599316, 112: 81.96005004427246}"
120,10,18,52.13879489788143,4,5,23,0.16800409489366186,"[0, 8, 9]",147.20489647757142,2.445913336377102,18,commuter,258,263,258,"{258: 147.20489647757142, 259: 144.75898314119434, 260: 137.421243132063, 261: 125.19167645017751, 262: 108.07028309553779}"
120,12,19,15.332395748176026,2,5,24,0.14280348065961254,"[12, 3, 2]",51.56074366552609,1.842311128116747,19,commuter,307,312,307,"{307: 51.56074366552609, 308: 49.71843253740934, 309: 44.1914991530591, 310: 34.979943512475366, 311: 22.083765615658137}"
120,9,18,62.18308120194257,4,6,24,0.16800409489366186,"[14, 13, 11]",111.5502853382499,1.514183830418042,18,commuter,234,240,234,"{234: 111.5502853382499, 235: 110.03610150783186, 236: 105.49355001657774, 237: 97.92263086448753, 238: 87.32334405156124, 239: 73.69568957779886}"
120,11,7,46.94127327831801,3,5,12,0.14000341241138486,"[13, 12, 7]",128.9438398815455,1.7174134370582075,7,commuter,271,276,271,"{271: 128.9438398815455, 272: 127.22642644448729, 273: 122.07418613331266, 274: 113.48711894802163, 275: 101.46522488861419}"
121,5,16,43.98443131529544,6,10,24,0.07459220784387294,"[14, 8, 6]",99.59358345483794,4.23672519003522,16,weekend_user,136,146,136,"{136: 99.59358345483794, 137: 95.35685826480272, 138: 82.64668269469706, 139: 61.463056744520955, 140: 31.805980414274416, 141: 0, 142: 0, 143: 0, 144: 0, 145: 0}"
121,12,13,66.34716539144588,8,12,24,0.07459220784387294,"[1, 12, 5]",108.12929755056484,4.0299046370393405,13,weekend_user,301,313,301,"{301: 108.12929755056484, 302: 104.0993929135255, 303: 92.00967900240748, 304: 71.86015581721078, 305: 43.650823357935394, 306: 7.381681624581333, 307: 0, 308: 0, 309: 0, 310: 0, 311: 0, 312: 0}"
122,6,15,27.892286224059188,2,3,18,0.07221316689583553,"[6, 4, 3]",140.58691063099718,4.596094908853466,15,commuter,159,162,159,"{159: 140.58691063099718, 160: 135.9908157221437, 161: 122.20253099558332}"
122,9,17,40.27802618292696,4,5,22,0.15292200048529875,"[14, 12, 3]",71.19815207992613,2.360900966089568,17,commuter,233,238,233,"{233: 71.19815207992613, 234: 68.83725111383656, 235: 61.75454821556786, 236: 49.950043385120026, 237: 33.423736622493045}"
122,12,12,32.90270489337241,4,6,18,0.07221316689583553,"[13, 12, 3]",137.11703319609725,2.088990145481885,12,commuter,300,306,300,"{300: 137.11703319609725, 301: 135.02804305061537, 302: 128.7610726141697, 303: 118.31612188676029, 304: 103.69319086838709, 305: 84.89227955905012}"
122,12,14,34.6211881887931,3,6,20,0.07221316689583553,"[2, 6, 14]",117.84266670087369,3.9203006664133166,14,commuter,302,308,302,"{302: 117.84266670087369, 303: 113.92236603446038, 304: 102.16146403522043, 305: 82.55996070315385, 306: 55.117856038260626, 307: 19.835150040540782}"
123,1,8,26.1083802031893,3,5,13,0.2554025262731757,"[1, 14, 2]",99.49425419019688,4.277084112574393,8,random,32,37,32,"{32: 99.49425419019688, 33: 95.21717007762248, 34: 82.38591773989931, 35: 61.00049717702735, 36: 31.0609083890066}"
123,0,13,27.443202412076683,2,4,17,0.17026835084878383,"[14, 12, 8]",58.658735817935025,3.369781763161657,13,random,13,17,13,"{13: 58.658735817935025, 14: 55.28895405477337, 15: 45.17960876528839, 16: 28.33069994948011}"
123,4,18,41.77171955315338,3,5,23,0.3064830315278109,"[3, 4, 6]",60.73539746460996,3.7888786432343577,18,random,114,119,114,"{114: 60.73539746460996, 115: 56.946518821375605, 116: 45.579882891672526, 117: 26.635489675500743, 118: 0.1133391728602362}"
124,1,10,23.546876597072536,2,5,15,0.2743868643215747,"[3, 4, 12]",92.76064874420298,4.277338496122475,10,work_charger,34,39,34,"{34: 92.76064874420298, 35: 88.4833102480805, 36: 75.65129475971308, 37: 54.26460227910071, 38: 24.323232806243382}"
124,8,12,46.05298633854313,5,10,22,0.2743868643215747,"[8, 13, 12]",139.46676243140138,1.0465064051414665,12,work_charger,204,214,204,"{204: 139.46676243140138, 205: 138.42025602625992, 206: 135.28073681083552, 207: 130.04820478512818, 208: 122.72265994913792, 209: 113.30410230286472, 210: 101.79253184630858, 211: 88.18794857946952, 212: 72.49035250234752, 213: 54.69974361494259}"
124,5,18,28.770672328037538,4,7,24,0.41981190241200933,"[4, 5, 7]",77.30388328862475,4.633979469813177,18,work_charger,138,145,138,"{138: 77.30388328862475, 139: 72.66990381881158, 140: 58.76796540937204, 141: 35.598068060306154, 142: 3.160211771613916, 143: 0, 144: 0}"
125,2,17,50.40903843150657,6,9,24,0.167812129186621,"[10, 2, 3]",74.71747445945176,4.894992856471842,17,commuter,65,74,65,"{65: 74.71747445945176, 66: 69.82248160297992, 67: 55.1375030335644, 68: 30.662538751205183, 69: 0, 70: 0, 71: 0, 72: 0, 73: 0}"
125,11,19,31.125826857325062,3,6,24,0.167812129186621,"[1, 0, 7]",89.86592875184121,1.5475212787673107,19,commuter,283,289,283,"{283: 89.86592875184121, 284: 88.3184074730739, 285: 83.67584363677197, 286: 75.93823724293541, 287: 65.10558829156423, 288: 51.17789678265844}"
125,11,17,59.047638920978684,3,4,21,0.167812129186621,"[11, 4, 0]",147.9613889098941,4.921566077442773,17,commuter,281,285,281,"{281: 147.9613889098941, 282: 143.03982283245134, 283: 128.275124600123, 284: 103.66729421290916}"
125,1,9,20.915094657477407,3,5,14,0.13984344098885082,"[2, 12, 13]",129.07548366741497,1.8029797966781183,9,commuter,33,38,33,"{33: 129.07548366741497, 34: 127.27250387073686, 35: 121.8635644807025, 36: 112.84866549731191, 37: 100.22780692056509}"
126,4,9,44.42389041166583,4,7,16,0.341159486783731,"[11, 13, 12]",75.38775483056547,2.3251870772159995,9,commuter,105,112,105,"{105: 75.38775483056547, 106: 73.06256775334947, 107: 66.08700652170147, 108: 54.461071135621474, 109: 38.18476159510948, 110: 17.258077900165482, 111: 0}"
126,12,14,58.807496289451535,8,11,24,0.19332370917744757,"[9, 8, 11]",80.92561104732854,3.572714467479583,14,commuter,302,313,302,"{302: 80.92561104732854, 303: 77.35289657984896, 304: 66.63475317741022, 305: 48.7711808400123, 306: 23.762179567655217, 307: 0, 308: 0, 309: 0, 310: 0, 311: 0, 312: 0}"
126,5,14,30.365781358931173,3,6,20,0.19332370917744757,"[8, 10, 2]",75.35061889250147,4.675917302001594,14,commuter,134,140,134,"{134: 75.35061889250147, 135: 70.67470159049988, 136: 56.6469496844951, 137: 33.26736317448713, 138: 0.5359420604759748, 139: 0}"
127,5,18,31.49740186498769,4,6,24,0.23601899015068997,"[8, 6, 10]",122.42407868134126,4.581614898233022,18,commuter,138,144,138,"{138: 122.42407868134126, 139: 117.84246378310823, 140: 104.09761908840917, 141: 81.18954459724407, 142: 49.1182403096129, 143: 7.883706225515695}"
127,0,9,41.09749436307588,3,4,13,0.23139116681440192,"[11, 8, 9]",101.63287225086414,3.7662815110722248,9,commuter,9,13,9,"{9: 101.63287225086414, 10: 97.86659073979192, 11: 86.56774620657524, 12: 67.73633865121411}"
127,1,17,38.13082364977326,3,4,21,0.27766940017728237,"[9, 13, 8]",124.65666738033929,4.218686471422234,17,commuter,41,45,41,"{41: 124.65666738033929, 42: 120.43798090891705, 43: 107.78192149465035, 44: 86.6884891375392}"
128,4,17,44.434181244952555,4,7,24,0.5338862536875878,"[3, 9, 1]",53.598982886866786,4.326277993459446,17,commuter,113,120,113,"{113: 53.598982886866786, 114: 49.27270489340734, 115: 36.293870913029, 116: 14.662480945731765, 117: 0, 118: 0, 119: 0}"
128,5,19,45.493246034411484,3,4,23,0.4538033156344496,"[1, 14, 9]",68.34642539688485,3.716276395907874,19,commuter,139,143,139,"{139: 68.34642539688485, 140: 64.63014900097699, 141: 53.48131981325336, 142: 34.899937833713985}"
128,8,7,40.76626992871858,5,6,13,0.4449052114063231,"[10, 11, 1]",145.89673461572463,2.3777652243494596,7,commuter,199,205,199,"{199: 145.89673461572463, 200: 143.51896939137518, 201: 136.38567371832679, 202: 124.49684759657949, 203: 107.85249102613326, 204: 86.45260400698814}"
128,3,7,36.41698157177683,2,3,10,0.4449052114063231,"[12, 14, 11]",57.97634254510711,2.607680747970706,7,commuter,79,82,79,"{79: 57.97634254510711, 80: 55.368661797136404, 81: 47.545619553224284}"
129,8,16,10.659412192581307,1,3,19,0.09852189417582158,"[0, 12, 11]",146.39534253882871,4.722844889330174,16,random,208,211,208,"{208: 146.39534253882871, 209: 141.67249764949855, 210: 127.50396298150801}"
130,4,18,51.72953243094172,3,5,23,0.3596652632767109,"[11, 12, 2]",109.96863142280594,2.328693838125428,18,commuter,114,119,114,"{114: 109.96863142280594, 115: 107.63993758468051, 116: 100.65385607030423, 117: 89.01038687967709, 118: 72.70953001279909}"
130,10,8,35.34426429761544,2,3,11,0.29972105273059235,"[9, 12, 1]",115.97281404048842,3.3005362176146296,8,commuter,248,251,248,"{248: 115.97281404048842, 249: 112.67227782287378, 250: 102.77066917002989}"
130,4,8,33.56488298542584,3,6,14,0.29972105273059235,"[4, 0, 7]",71.15009605797873,2.1480124220367944,8,commuter,104,110,104,"{104: 71.15009605797873, 105: 69.00208363594193, 106: 62.55804636983155, 107: 51.81798425964758, 108: 36.78189730539002, 109: 17.44978550705887}"
130,5,19,54.18852062539888,4,6,24,0.3057154737852042,"[0, 13, 10]",129.99481482923824,4.923670912715328,19,commuter,139,145,139,"{139: 129.99481482923824, 140: 125.07114391652291, 141: 110.30013117837693, 142: 85.68177661480028, 143: 51.21608022579299, 144: 6.903042011355041}"
130,12,19,38.57906925253969,4,6,24,0.3057154737852042,"[4, 1, 7]",107.62532950885922,4.808949141662977,19,commuter,307,313,307,"{307: 107.62532950885922, 308: 102.81638036719625, 309: 88.38953294220732, 310: 64.34478723389243, 311: 30.6821432422516, 312: 0}"
131,13,11,23.540970012348055,2,5,16,0.08597880480834226,"[9, 8, 3]",96.34777312306679,3.422613087286387,11,commuter,323,328,323,"{323: 96.34777312306679, 324: 92.9251600357804, 325: 82.65732077392124, 326: 65.5442553374893, 327: 41.58596372648459}"
131,9,9,36.99085200215778,5,7,16,0.15172730260295691,"[6, 10, 12]",78.88294299196087,2.636030946945093,9,commuter,225,232,225,"{225: 78.88294299196087, 226: 76.24691204501578, 227: 68.33881920418051, 228: 55.15866446945504, 229: 36.70644784083939, 230: 12.982169318333547, 231: 0}"
131,9,8,22.73238885893957,3,6,14,0.15172730260295691,"[14, 3, 10]",117.24062935955757,3.7195099488923526,8,commuter,224,230,224,"{224: 117.24062935955757, 225: 113.52111941066522, 226: 102.36258956398817, 227: 83.76503981952641, 228: 57.72847017727993, 229: 24.25288063724875}"
131,8,7,30.97628730793341,2,5,12,0.15172730260295691,"[1, 9, 8]",115.6731206223462,1.5868023033346397,7,commuter,199,204,199,"{199: 115.6731206223462, 200: 114.08631831901157, 201: 109.32591140900765, 202: 101.39189989233445, 203: 90.28428376899197}"
132,5,19,31.802902348640497,3,4,23,0.11546507952403189,"[12, 14, 3]",129.8704573842639,1.8425823905421468,19,commuter,139,143,139,"{139: 129.8704573842639, 140: 128.02787499372175, 141: 122.5001278220953, 142: 113.28721586938457}"
132,7,19,37.2102482052385,3,5,24,0.13584127002827281,"[11, 3, 4]",113.02625280840806,2.768242841576892,19,commuter,187,192,187,"{187: 113.02625280840806, 188: 110.25800996683117, 189: 101.95328144210049, 190: 88.11206723421603, 191: 68.73436734317778}"
132,0,19,21.963681249454456,2,3,22,0.13584127002827281,"[2, 0, 6]",145.66005677673076,2.5651074216277823,19,commuter,19,22,19,"{19: 145.66005677673076, 20: 143.09494935510298, 21: 135.39962709021964}"
132,1,9,40.517779603606485,3,4,13,0.11320105835689401,"[14, 9, 12]",119.93788657332212,3.940463299361584,9,commuter,33,37,33,"{33: 119.93788657332212, 34: 115.99742327396054, 35: 104.17603337587579, 36: 84.47371687906787}"
132,3,19,37.38204518839059,4,7,24,0.13584127002827281,"[2, 5, 6]",60.602718995537884,4.75294128902253,19,commuter,91,98,91,"{91: 60.602718995537884, 92: 55.849777706515354, 93: 41.590953839447764, 94: 17.826247394335113, 95: 0, 96: 0, 97: 0}"
133,2,12,21.98837982727884,2,4,16,0.24630286775959165,"[7, 2, 3]",95.27866366953424,3.061939637549169,12,work_charger,60,64,60,"{60: 95.27866366953424, 61: 92.21672403198507, 62: 83.03090511933756, 63: 67.72120693159172}"
133,3,11,69.86335576476779,8,10,21,0.24630286775959165,"[7, 11, 8]",78.56488707180552,1.9935864349357524,11,work_charger,83,93,83,"{83: 78.56488707180552, 84: 76.57130063686976, 85: 70.5905413320625, 86: 60.62260915738374, 87: 46.66750411283348, 88: 28.725226198411704, 89: 6.795775414118424, 90: 0, 91: 0, 92: 0}"
133,1,9,73.19036032395923,8,11,20,0.3694543016393874,"[4, 1, 10]",106.7826091399584,2.3977004507751523,9,work_charger,33,44,33,"{33: 106.7826091399584, 34: 104.38490868918325, 35: 97.19180733685779, 36: 85.20330508298203, 37: 68.41940192755595, 38: 46.84009787057959, 39: 20.46539291205292, 40: 0, 41: 0, 42: 0, 43: 0}"
133,1,13,18.848489278530124,2,5,18,0.24630286775959165,"[9, 1, 14]",96.54389706003232,4.706127096396413,13,work_charger,37,42,37,"{37: 96.54389706003232, 38: 91.8377699636359, 39: 77.71938867444666, 40: 54.1887531924646, 41: 21.245863517689713}"
134,8,9,59.351678670784906,4,6,15,0.3654869723348205,"[11, 12, 7]",136.07285593880846,1.0616598337936307,9,commuter,201,207,201,"{201: 136.07285593880846, 202: 135.01119610501482, 203: 131.82621660363392, 204: 126.51791743466578, 205: 119.08629859811037, 206: 109.53136009396769}"
134,3,7,35.533392493909105,3,6,13,0.3654869723348205,"[0, 4, 1]",62.661982904502366,4.261717976046273,7,commuter,79,85,79,"{79: 62.661982904502366, 80: 58.400264928456096, 81: 45.61511100031727, 82: 24.30652112008591, 83: 0, 84: 0}"
134,6,15,26.42228142669323,2,4,19,0.20710928432306497,"[12, 3, 7]",57.72934931504658,2.0314800141920344,15,commuter,159,163,159,"{159: 57.72934931504658, 160: 55.69786930085455, 161: 49.603429258278446, 162: 39.446029187318274}"
134,3,9,44.99740404818044,4,7,16,0.3654869723348205,"[2, 13, 11]",51.82053031031985,1.5142724234207323,9,commuter,81,88,81,"{81: 51.82053031031985, 82: 50.30625788689912, 83: 45.76344061663693, 84: 38.19207849953327, 85: 27.592171535588136, 86: 13.963719724801543, 87: 0}"
134,9,19,12.434970709592072,2,5,24,0.4385843668017847,"[8, 7, 2]",104.23939642683995,1.8888288279839278,19,commuter,235,240,235,"{235: 104.23939642683995, 236: 102.35056759885602, 237: 96.68408111490423, 238: 87.2399369749846, 239: 74.0181351790971}"
135,0,8,19.128699354008788,2,5,13,0.22264659454775085,"[12, 13, 0]",55.15548732662513,4.834973187633749,8,commuter,8,13,8,"{8: 55.15548732662513, 9: 50.32051413899138, 10: 35.815594576090135, 11: 11.640728637921384, 12: 0}"
135,5,18,14.46712991947814,1,3,21,0.22709952643870587,"[8, 2, 10]",135.77589578071112,3.203581503078279,18,commuter,138,141,138,"{138: 135.77589578071112, 139: 132.57231427763284, 140: 122.96156976839801}"
135,12,10,26.958195076943845,2,3,13,0.12616640357705883,"[0, 2, 11]",70.49160325159997,4.578856419022451,10,commuter,298,301,298,"{298: 70.49160325159997, 299: 65.91274683257751, 300: 52.17617757551017}"
135,8,18,32.916014744100764,4,7,24,0.2671759134573011,"[7, 3, 11]",138.84317051440962,4.4051553571900595,18,commuter,210,217,210,"{210: 138.84317051440962, 211: 134.43801515721955, 212: 121.22254908564938, 213: 99.19677229969909, 214: 68.36068479936867, 215: 28.71428658465814, 216: 0}"
135,11,19,21.084895517539557,1,3,22,0.2671759134573011,"[13, 6, 8]",145.52861960018222,2.1987670634982583,19,commuter,283,286,283,"{283: 145.52861960018222, 284: 143.32985253668397, 285: 136.7335513461892}"
136,11,18,44.63030100183424,6,9,24,0.1500350272293847,"[2, 13, 8]",121.88142666942387,1.9011555674501772,18,commuter,282,291,282,"{282: 121.88142666942387, 283: 119.9802711019737, 284: 114.27680439962316, 285: 104.77102656237227, 286: 91.46293759022103, 287: 74.35253748316944, 288: 53.43982624121749, 289: 28.724803864365185, 290: 0.20747035261253188}"
136,10,9,22.957657498883343,4,6,15,0.12502918935782056,"[11, 12, 10]",119.21797335437422,3.0249570663886316,9,commuter,249,255,249,"{249: 119.21797335437422, 250: 116.19301628798559, 251: 107.1181450888197, 252: 91.99335975687654, 253: 70.81866029215612, 254: 43.59404669465843}"
136,10,8,8.852783803624234,1,4,12,0.12502918935782056,"[0, 3, 9]",123.78348386983485,3.151564331940047,8,commuter,248,252,248,"{248: 123.78348386983485, 249: 120.6319195378948, 250: 111.17722654207466, 251: 95.41940488237444}"
136,0,7,37.375265604550606,6,9,16,0.12502918935782056,"[6, 3, 1]",72.50916645946802,3.1345425249481704,7,commuter,7,16,7,"{7: 72.50916645946802, 8: 69.37462393451985, 9: 59.97099635967534, 10: 44.298283734934486, 11: 22.356486060297293, 12: 0, 13: 0, 14: 0, 15: 0}"
137,0,8,23.965109253879064,2,5,13,0.2732921416836576,"[8, 3, 9]",99.82116867122437,4.571322505052958,8,random,8,13,8,"{8: 99.82116867122437, 9: 95.24984616617141, 10: 81.53587865101254, 11: 58.679266125747745, 12: 26.680008590377042}"
137,10,14,41.07916896773141,3,4,18,0.1821947611224384,"[7, 10, 8]",127.59739087498882,3.877074023794459,14,random,254,258,254,"{254: 127.59739087498882, 255: 123.72031685119435, 256: 112.08909477981098, 257: 92.70372466083869}"
137,3,9,35.25311860206917,5,7,16,0.2732921416836576,"[2, 7, 13]",145.860855004442,2.480653422545509,9,random,81,88,81,"{81: 145.860855004442, 82: 143.38020158189647, 83: 135.93824131425995, 84: 123.5349742015324, 85: 106.17040024371384, 86: 83.84451944080426, 87: 56.557331792803666}"
138,2,13,54.26208201025159,5,8,21,0.14415221599008918,"[8, 7, 9]",124.04646509447302,2.7635243904743203,13,work_charger,61,69,61,"{61: 124.04646509447302, 62: 121.2829407039987, 63: 112.99236753257574, 64: 99.17474558020413, 65: 79.83007484688389, 66: 54.958355332615014, 67: 24.559587037397492, 68: 0}"
138,0,10,76.69792898469058,4,8,18,0.14415221599008918,"[6, 0, 7]",139.8445534144183,1.7618006224300755,10,work_charger,10,18,10,"{10: 139.8445534144183, 11: 138.0827527919882, 12: 132.797350924698, 13: 123.98834781254762, 14: 111.65574345553709, 15: 95.79953785366641, 16: 76.41973100693558, 17: 53.5163229153446}"
138,6,12,77.9275863898835,5,8,20,0.12252938359157581,"[6, 3, 5]",62.909634985963336,2.826047026887161,12,work_charger,156,164,156,"{156: 62.909634985963336, 157: 60.083587959076176, 158: 51.605446878414696, 159: 37.47521174397889, 160: 17.69288255576876, 161: 0, 162: 0, 163: 0}"
139,10,9,62.22772371416491,3,4,13,0.37328406916370127,"[0, 12, 9]",102.38430787368449,4.777408333887001,9,commuter,249,253,249,"{249: 102.38430787368449, 250: 97.6068995397975, 251: 83.27467453813648, 252: 59.38763286870148}"
139,8,9,37.48515008852821,2,3,12,0.37328406916370127,"[11, 12, 9]",142.4237700814133,4.300155642493447,9,commuter,201,204,201,"{201: 142.4237700814133, 202: 138.12361443891984, 203: 125.2231475114395}"
139,1,9,65.30579484448553,6,7,16,0.37328406916370127,"[3, 11, 9]",70.66729377890758,2.361326033756827,9,commuter,33,40,33,"{33: 70.66729377890758, 34: 68.30596774515075, 35: 61.22198964388027, 36: 49.41535947509613, 37: 32.88607723879834, 38: 11.634142934986897, 39: 0}"
139,8,9,25.17400985962899,3,6,15,0.37328406916370127,"[12, 10, 0]",126.16762854462486,1.4263897993174002,9,commuter,201,207,201,"{201: 126.16762854462486, 202: 124.74123874530746, 203: 120.46206934735525, 204: 113.33012035076825, 205: 103.34539175554646, 206: 90.50788356168985}"
140,3,17,84.75769110212244,8,10,24,0.1641603897778154,"[0, 11, 7]",52.90387826597745,1.162002745927678,17,commuter,89,99,89,"{89: 52.90387826597745, 90: 51.74187552004977, 91: 48.255867282266735, 92: 42.44585355262834, 93: 34.3118343311346, 94: 23.853809617785494, 95: 11.071779412581037, 96: 0, 97: 0, 98: 0}"
140,8,18,87.61162321252378,8,9,24,0.1641603897778154,"[2, 8, 9]",123.41069808811267,3.483496750227205,18,commuter,210,219,210,"{210: 123.41069808811267, 211: 119.92720133788546, 212: 109.47671108720385, 213: 92.05922733606782, 214: 67.67475008447738, 215: 36.32327933243255, 216: 0, 217: 0, 218: 0}"
140,5,12,45.25371247791404,5,6,18,0.07752018406174616,"[1, 3, 7]",113.3283513639688,1.7329228749686223,12,commuter,132,138,132,"{132: 113.3283513639688, 133: 111.59542848900018, 134: 106.39665986409432, 135: 97.7320454892512, 136: 85.60158536447085, 137: 70.00527948975325}"
141,11,12,45.54807316181218,6,11,23,0.13483636761025888,"[6, 7, 10]",54.28970109935717,1.6836211597770943,12,work_charger,276,287,276,"{276: 54.28970109935717, 277: 52.60607993958007, 278: 47.555216460248786, 279: 39.13711066136332, 280: 27.35176254292366, 281: 12.199172104929808, 282: 0, 283: 0, 284: 0, 285: 0, 286: 0}"
141,2,10,36.39388790747168,3,5,15,0.13483636761025888,"[11, 13, 4]",133.63910602863055,2.8351594611614312,10,work_charger,58,63,58,"{58: 133.63910602863055, 59: 130.80394656746913, 60: 122.29846818398482, 61: 108.12267087817767, 62: 88.27655465004764}"
141,5,14,44.87050245959838,3,7,21,0.11461091246872004,"[14, 6, 3]",61.43231141191252,3.961219163023927,14,work_charger,134,141,134,"{134: 61.43231141191252, 135: 57.471092248888596, 136: 45.587434759816816, 137: 25.781338944697175, 138: 0, 139: 0, 140: 0}"
141,12,15,27.34883748418997,3,5,20,0.11461091246872004,"[4, 0, 14]",84.04506955436057,2.247886169729683,15,work_charger,303,308,303,"{303: 84.04506955436057, 304: 81.79718338463088, 305: 75.05352487544184, 306: 63.81409402679342, 307: 48.07889083868564}"
142,4,10,36.28768768778777,3,8,18,0.09152630550675953,"[7, 9, 14]",147.33791957751174,2.0486556416351975,10,work_charger,106,114,106,"{106: 147.33791957751174, 107: 145.28926393587653, 108: 139.14329701097094, 109: 128.90001880279496, 110: 114.55942931134858, 111: 96.1215285366318, 112: 73.58631647864463, 113: 46.953793137387066}"
142,4,8,43.14007054075956,3,6,14,0.13728945826013927,"[1, 10, 14]",141.1796398758383,3.869184310293712,8,work_charger,104,110,104,"{104: 141.1796398758383, 105: 137.31045556554457, 106: 125.70290263466345, 107: 106.35698108319488, 108: 79.27269091113891, 109: 44.4500321184955}"
142,8,13,31.68693712642686,3,6,19,0.09152630550675953,"[4, 1, 11]",89.07025506881092,4.064319996472885,13,work_charger,205,211,205,"{205: 89.07025506881092, 206: 85.00593507233803, 207: 72.81297508291938, 208: 52.49137510055496, 209: 24.041135125244764, 210: 0}"
143,3,18,28.482334062479982,4,5,23,0.1455202585603855,"[8, 0, 7]",138.52828290969003,2.4463610656812387,18,commuter,90,95,90,"{90: 138.52828290969003, 91: 136.0819218440088, 92: 128.74283864696508, 93: 116.51103331855889, 94: 99.38650585879022}"
143,2,7,32.56632597504915,3,5,12,0.12126688213365457,"[4, 3, 13]",143.8337202621459,1.0501927967556357,7,commuter,55,60,55,"{55: 143.8337202621459, 56: 142.78352746539028, 57: 139.63294907512335, 58: 134.38198509134517, 59: 127.03063551405573}"
143,5,14,31.27045436957728,3,5,19,0.06871789987573759,"[7, 8, 10]",96.55955048379242,3.80625416195807,14,commuter,134,139,134,"{134: 96.55955048379242, 135: 92.75329632183436, 136: 81.33453383596014, 137: 62.30326302616979, 138: 35.6594838924633}"
143,4,7,35.064427079303016,2,3,10,0.12126688213365457,"[9, 4, 10]",83.48562145762119,4.6782354512531406,7,commuter,103,106,103,"{103: 83.48562145762119, 104: 78.80738600636805, 105: 64.77267965260863}"
144,13,16,34.92763694259773,4,9,24,0.15015108367171093,"[12, 4, 7]",117.96699732515225,4.018117355306966,16,work_charger,328,337,328,"{328: 117.96699732515225, 329: 113.94887996984528, 330: 101.89452790392438, 331: 81.80394112738955, 332: 53.67711964024079, 333: 17.51406344247809, 334: 0, 335: 0}"
144,7,10,34.49662305358791,2,6,16,0.1766483337314246,"[14, 8, 6]",105.15874589482459,1.4628495770540884,10,work_charger,178,184,178,"{178: 105.15874589482459, 179: 103.6958963177705, 180: 99.30734758660824, 181: 91.9930997013378, 182: 81.75315266195918, 183: 68.58750646847238}"
144,7,8,39.99724489319278,3,8,16,0.2649725005971369,"[1, 6, 12]",95.12153132783962,1.596358995072991,8,work_charger,176,184,176,"{176: 95.12153132783962, 177: 93.52517233276663, 178: 88.73609534754766, 179: 80.7543003721827, 180: 69.57978740667176, 181: 55.21255645101484, 182: 37.65260750521194, 183: 16.89994056926305}"
145,12,17,24.52018890773833,3,9,24,0.13412471430324344,"[13, 11, 4]",93.31770489758873,1.5734006162148857,17,weekend_user,305,314,305,"{305: 93.31770489758873, 306: 91.74430428137384, 307: 87.02410243272918, 308: 79.15709935165475, 309: 68.14329503815055, 310: 53.982689492216586, 311: 36.67528271385284, 312: 16.22107470305933, 313: 0}"
145,5,19,42.78076741604303,5,8,24,0.13412471430324344,"[3, 1, 9]",149.04015345821995,4.516746978609024,19,weekend_user,139,147,139,"{139: 149.04015345821995, 140: 144.5234064796109, 141: 130.97316554378386, 142: 108.38943065073873, 143: 76.77220180047556, 144: 36.12147899299434, 145: 0, 146: 0}"
146,13,19,61.888630697978286,3,6,24,0.38988120821457406,"[9, 7, 12]",143.5974084710724,4.9568261031923715,19,commuter,331,337,331,"{331: 143.5974084710724, 332: 138.64058236788003, 333: 123.77010405830293, 334: 98.98597354234107, 335: 64.28819081999447}"
146,12,17,77.15552722752501,4,7,24,0.38988120821457406,"[4, 13, 0]",79.26376817221757,2.696208740857969,17,commuter,305,312,305,"{305: 79.26376817221757, 306: 76.5675594313596, 307: 68.47893320878569, 308: 54.997889504495845, 309: 36.12442831849006, 310: 11.858549650768339, 311: 0}"
146,6,15,57.87868465264873,4,6,21,0.21660067123031895,"[12, 10, 7]",138.52289842111725,2.00805893471621,15,commuter,159,165,159,"{159: 138.52289842111725, 160: 136.51483948640103, 161: 130.4906626822524, 162: 120.45036800867136, 163: 106.39395546565788, 164: 88.32142505321201}"
146,11,7,65.40879215538291,4,5,12,0.38223647864173926,"[6, 13, 7]",101.61245842024867,2.3310548613427176,7,commuter,271,276,271,"{271: 101.61245842024867, 272: 99.28140355890595, 273: 92.2882389748778, 274: 80.63296466816422, 275: 64.3155806387652}"
146,8,9,37.88336610034297,3,4,13,0.38223647864173926,"[5, 8, 4]",136.36964590026923,2.2552751213086464,9,commuter,201,205,201,"{201: 136.36964590026923, 202: 134.1143707789606, 203: 127.34854541503465, 204: 116.07216980849142}"
147,13,10,43.20246067479373,3,6,16,0.06898338735213133,"[2, 4, 12]",145.04418025483443,3.8659118676557993,10,work_charger,322,328,322,"{322: 145.04418025483443, 323: 141.17826838717863, 324: 129.58053278421124, 325: 110.25097344593223, 326: 83.18959037234164, 327: 48.39638356343944}"
147,6,19,34.12330036252843,3,8,24,0.12417009723383639,"[5, 4, 8]",97.57937917347357,4.34445121971075,19,work_charger,163,171,163,"{163: 97.57937917347357, 164: 93.23492795376282, 165: 80.20157429463057, 166: 58.47931819607682, 167: 28.068159658101564, 168: 0, 169: 0, 170: 0}"
147,10,11,86.1219203613151,6,10,21,0.08115692629662509,"[14, 11, 2]",103.5631652847232,1.5484127522973146,11,work_charger,251,261,251,"{251: 103.5631652847232, 252: 102.01475253242589, 253: 97.36951427553394, 254: 89.62745051404737, 255: 78.78856124796616, 256: 64.85284647729034, 257: 47.82030620201987, 258: 27.69094042215478, 259: 4.464749137695065, 260: 0}"
147,9,10,47.90820018861113,3,8,18,0.08115692629662509,"[0, 11, 1]",53.67079828046284,1.7422984109801911,10,work_charger,226,234,226,"{226: 53.67079828046284, 227: 51.92849986948265, 228: 46.70160463654207, 229: 37.99011258164112, 230: 25.794023704779782, 231: 10.113338005958063, 232: 0, 233: 0}"
148,3,22,40.089403358669315,5,12,24,0.1016154952466413,"[8, 1, 11]",61.02329087212327,4.157518533847698,22,night_charger,94,106,94,"{94: 61.02329087212327, 95: 56.86577233827557, 96: 44.39321673673248, 97: 23.605624067493984, 98: 0, 99: 0, 100: 0, 101: 0, 102: 0, 103: 0, 104: 0, 105: 0}"
148,6,21,36.95918748302174,2,9,24,0.08637317095964511,"[12, 4, 9]",69.27435072123684,2.2100158414056463,21,night_charger,165,174,165,"{165: 69.27435072123684, 166: 67.0643348798312, 167: 60.43428735561426, 168: 49.384208148586026, 169: 33.9140972587465, 170: 14.023954686095685, 171: 0, 172: 0, 173: 0}"
148,12,22,31.50395010606046,3,9,24,0.08637317095964511,"[14, 3, 9]",108.43514169821128,2.4784217647810753,22,night_charger,310,319,310,"{310: 108.43514169821128, 311: 105.95671993343021, 312: 98.52145463908698, 313: 86.12934581518161, 314: 68.78039346171408, 315: 46.474597578684396, 316: 19.211958166092572, 317: 0, 318: 0}"
149,4,7,97.16785165607766,7,9,16,0.12421742427789535,"[11, 14, 9]",128.21012254841065,3.131299445250441,7,random,103,112,103,"{103: 128.21012254841065, 104: 125.07882310316022, 105: 115.68492476740889, 106: 100.02842754115669, 107: 78.10933142440359, 108: 49.92763641714963, 109: 15.483342519394782, 110: 0, 111: 0}"
149,9,8,66.54541462716877,4,5,13,0.12421742427789535,"[13, 2, 5]",111.34927718519796,1.382744829223625,8,random,224,229,224,"{224: 111.34927718519796, 225: 109.96653235597434, 226: 105.81829786830346, 227: 98.90457372218533, 228: 89.22535991761995}"
150,1,17,58.212380821671296,4,6,23,0.5396949651236437,"[8, 1, 14]",107.32866576070838,1.6041399699877044,17,commuter,41,47,41,"{41: 107.32866576070838, 42: 105.72452579072068, 43: 100.91210588075757, 44: 92.89140603081904, 45: 81.6624262409051, 46: 67.22516651101577}"
150,6,14,73.60024888673578,8,11,24,0.25485595575283176,"[3, 1, 6]",83.74147086864342,3.623669409927894,14,commuter,158,169,158,"{158: 83.74147086864342, 159: 80.11780145871552, 160: 69.24679322893184, 161: 51.128446179292375, 162: 25.762760309797116, 163: 0, 164: 0, 165: 0, 166: 0, 167: 0, 168: 0}"
150,9,19,24.85004747457982,2,5,24,0.5396949651236437,"[6, 11, 7]",110.9695455144984,3.8949855416311423,19,commuter,235,240,235,"{235: 110.9695455144984, 236: 107.07455997286726, 237: 95.38960334797383, 238: 75.91467563981813, 239: 48.64977684840013}"
150,6,10,83.63097425205095,5,7,17,0.25485595575283176,"[8, 6, 14]",100.7560249110526,3.2090710098010713,10,commuter,154,161,154,"{154: 100.7560249110526, 155: 97.54695390125154, 156: 87.91974087184832, 157: 71.87438582284297, 158: 49.410888754235465, 159: 20.52924966602582, 160: 0}"
151,12,11,46.65772175175944,4,6,17,0.1691830476511593,"[14, 13, 10]",123.59964883305143,4.7459329920683,11,commuter,299,305,299,"{299: 123.59964883305143, 300: 118.85371584098313, 301: 104.61591686477823, 302: 80.88625190443673, 303: 47.66472095995863, 304: 4.95132403134393}"
151,12,11,65.52904735603241,4,5,16,0.1691830476511593,"[13, 10, 8]",127.48498465340991,3.959286537462386,11,commuter,299,304,299,"{299: 127.48498465340991, 300: 123.52569811594752, 301: 111.64783850356037, 302: 91.85140581624844, 303: 64.13640005401174}"
151,9,7,46.68349787387996,4,7,14,0.29855831938439875,"[8, 5, 10]",72.5336911454328,4.8971502240504,7,commuter,223,230,223,"{223: 72.5336911454328, 224: 67.63654092138239, 225: 52.9450902492312, 226: 28.459339128979195, 227: 0, 228: 0, 229: 0}"
151,6,19,60.49718507457965,4,5,24,0.3045294857720867,"[5, 10, 12]",106.67645638523757,1.9191827344210375,19,commuter,163,168,163,"{163: 106.67645638523757, 164: 104.75727365081653, 165: 98.99972544755342, 166: 89.40381177544823, 167: 75.96953263450098}"
151,0,8,42.10573733015741,3,5,13,0.29855831938439875,"[9, 6, 10]",94.32859860792395,2.7868862239594945,8,commuter,8,13,8,"{8: 94.32859860792395, 9: 91.54171238396445, 10: 83.18105371208597, 11: 69.2466225922885, 12: 49.73841902457204}"
152,1,10,20.19904411450998,2,7,17,0.1382948508939767,"[3, 0, 4]",89.34481532236359,1.5274079585735878,10,work_charger,34,41,34,"{34: 89.34481532236359, 35: 87.81740736379, 36: 83.23518348806924, 37: 75.5981436952013, 38: 64.90628798518618, 39: 51.15961635802389, 40: 34.35812881371443}"
152,7,9,25.266187851440524,2,5,14,0.20744227634096504,"[6, 11, 5]",120.1599349899597,2.7384094748719674,9,work_charger,177,182,177,"{177: 120.1599349899597, 178: 117.42152551508772, 179: 109.20629709047182, 180: 95.51424971611199, 181: 76.34538339200822}"
152,10,9,34.37673936342298,2,5,14,0.20744227634096504,"[3, 2, 4]",73.0374822366024,3.3176225243466186,9,work_charger,249,254,249,"{249: 73.0374822366024, 250: 69.71985971225578, 251: 59.76699213921593, 252: 43.178879517482834, 253: 19.955521847056502}"
152,1,8,22.924450878184167,2,6,14,0.20744227634096504,"[7, 0, 9]",120.31385432874808,2.4198641239446204,8,work_charger,32,38,32,"{32: 120.31385432874808, 33: 117.89399020480346, 34: 110.6343978329696, 35: 98.5350772132465, 36: 81.59602834563415, 37: 59.81725123013257}"
153,5,11,57.984243598291414,3,6,17,0.11924197399467007,"[6, 7, 13]",71.29395476323428,2.5622975103698753,11,weekend_user,131,137,131,"{131: 71.29395476323428, 132: 68.73165725286441, 133: 61.04476472175478, 134: 48.233277169905406, 135: 30.297194597316278, 136: 7.236517003987402}"
153,12,13,56.40347393152894,8,12,24,0.11924197399467007,"[11, 6, 12]",52.21399530338714,3.1060988430845597,13,weekend_user,301,313,301,"{301: 52.21399530338714, 302: 49.10789646030258, 303: 39.7895999310489, 304: 24.2591057156261, 305: 2.5164138140341805, 306: 0, 307: 0, 308: 0, 309: 0, 310: 0, 311: 0, 312: 0}"
154,8,22,54.976248652681576,4,9,24,0.17855111319894934,"[3, 12, 7]",51.42907700407003,3.930131317204101,22,night_charger,214,223,214,"{214: 51.42907700407003, 215: 47.49894568686593, 216: 35.70855173525363, 217: 16.05789514923312, 218: 0, 219: 0, 220: 0, 221: 0, 222: 0}"
154,0,19,47.1922006900205,4,12,24,0.32139200375810884,"[8, 1, 13]",77.88331728178167,1.8144108629386193,19,night_charger,19,31,19,"{19: 77.88331728178167, 20: 76.06890641884306, 21: 70.6256738300272, 22: 61.5536195153341, 23: 48.85274347476376, 24: 32.52304570831619, 25: 12.564526215991378, 26: 0, 27: 0, 28: 0, 29: 0, 30: 0}"
154,8,23,23.40703649469701,3,11,24,0.12498577923926453,"[12, 1, 8]",66.01282401846402,1.030921069361396,23,night_charger,215,226,215,"{215: 66.01282401846402, 216: 64.98190294910262, 217: 61.88913974101843, 218: 56.73453439421145, 219: 49.51808690868168, 220: 40.239797284429116, 221: 28.899665521453763, 222: 15.497691619755614, 223: 0.03387557933467633, 224: 0, 225: 0}"
155,11,18,30.21524517603703,4,7,24,0.251767522280705,"[10, 11, 7]",100.65538158814176,1.1306201383768104,18,random,282,289,282,"{282: 100.65538158814176, 283: 99.52476144976495, 284: 96.13290103463453, 285: 90.47980034275047, 286: 82.5654593741128, 287: 72.3898781287215, 288: 59.95305660657659}"
155,3,20,26.26088636959971,3,6,24,0.251767522280705,"[5, 14, 11]",74.6187357461253,3.6790756095584047,20,random,92,98,92,"{92: 74.6187357461253, 93: 70.93966013656689, 94: 59.90243330789168, 95: 41.507055260099655, 96: 15.75352599319082, 97: 0}"
156,12,19,42.25071455433356,3,8,24,0.3310383896232263,"[1, 4, 8]",51.8317207215725,2.0025770204639186,19,night_charger,307,315,307,"{307: 51.8317207215725, 308: 49.829143701108585, 309: 43.821412639716826, 310: 33.80852753739724, 311: 19.790488394149804, 312: 1.7672952099745345, 313: 0, 314: 0}"
156,13,22,27.71470712876751,3,9,24,0.18391021645734795,"[8, 14, 7]",142.6578917143126,3.607817379936681,22,night_charger,334,343,334,"{334: 142.6578917143126, 335: 139.05007433437592}"
156,1,22,23.188557496600254,2,9,24,0.2163649605380564,"[3, 14, 9]",138.37959840764773,4.675984652316242,22,night_charger,46,55,46,"{46: 138.37959840764773, 47: 133.7036137553315, 48: 119.67565979838277, 49: 96.29573653680156, 50: 63.56384397058787, 51: 21.47998209974169, 52: 0, 53: 0, 54: 0}"
157,13,11,70.12108779131259,6,7,18,0.113926592758595,"[5, 0, 6]",117.34898115131833,2.6879286644262845,11,random,323,330,323,"{323: 117.34898115131833, 324: 114.66105248689205, 325: 106.59726649361319, 326: 93.15762317148176, 327: 74.34212252049778, 328: 50.150764540661214, 329: 20.583549231972086}"
158,7,9,31.824267916110752,3,6,15,0.13207856786150274,"[14, 9, 1]",100.21484526369852,4.450227330095403,9,commuter,177,183,177,"{177: 100.21484526369852, 178: 95.76461793360312, 179: 82.41393594331691, 180: 60.16279929283989, 181: 29.011207982172067, 182: 0}"
158,0,9,39.030313493252535,4,7,16,0.13207856786150274,"[7, 2, 1]",54.23497474764143,3.235268939673286,9,commuter,9,16,9,"{9: 54.23497474764143, 10: 50.99970580796815, 11: 41.293898988948285, 12: 25.117554290581857, 13: 2.4706717128688567, 14: 0, 15: 0}"
158,12,14,19.190764724656173,2,4,18,0.0748445217881849,"[5, 14, 10]",95.272542662994,4.173379311443904,14,commuter,302,306,302,"{302: 95.272542662994, 303: 91.09916335155009, 304: 78.57902541721839, 305: 57.71212885999886}"
158,4,9,24.782658432672758,2,5,14,0.13207856786150274,"[2, 8, 14]",106.60475729241843,1.1776098624241214,9,commuter,105,110,105,"{105: 106.60475729241843, 106: 105.4271474299943, 107: 101.89431784272195, 108: 96.00626853060133, 109: 87.76299949363249}"
159,5,11,45.360985423792734,3,4,15,0.10462782451774814,"[13, 5, 11]",104.69958503385206,2.0265072156609114,11,commuter,131,135,131,"{131: 104.69958503385206, 132: 102.67307781819115, 133: 96.59355617120842, 134: 86.46102009290385}"
159,5,18,20.120431634103344,1,2,20,0.18833008413194663,"[0, 2, 14]",96.85469497914723,4.469382018808449,18,commuter,138,140,138,"{138: 96.85469497914723, 139: 92.38531296033878}"
159,0,9,56.80233179697572,4,5,14,0.18463733738426139,"[2, 13, 1]",104.29884037464055,2.2560317010940465,9,commuter,9,14,9,"{9: 104.29884037464055, 10: 102.0428086735465, 11: 95.27471357026437, 12: 83.99455506479413, 13: 68.2023331571358}"
159,9,8,49.19967061085009,3,4,12,0.18463733738426139,"[14, 0, 13]",110.90816550210135,4.229257203076209,8,commuter,224,228,224,"{224: 110.90816550210135, 225: 106.67890829902515, 226: 93.99113668979652, 227: 72.84485067441548}"
160,0,8,78.43963009596659,8,12,20,0.42694486344961285,"[11, 8, 1]",94.54054285778349,2.4203790654527593,8,work_charger,8,20,8,"{8: 94.54054285778349, 9: 92.12016379233073, 10: 84.85902659597245, 11: 72.75713126870866, 12: 55.814477810539344, 13: 34.03106622146451, 14: 7.406896501484155, 15: 0, 16: 0, 17: 0, 18: 0, 19: 0}"
160,6,15,36.560600851938275,2,6,21,0.24193542262144732,"[8, 0, 11]",67.2361915885375,1.1272221249353653,15,work_charger,159,165,159,"{159: 67.2361915885375, 160: 66.10896946360212, 161: 62.727303088796035, 162: 57.0911924641192, 163: 49.20063758957165, 164: 39.055638465153365}"
160,2,9,51.52982901091944,6,11,20,0.42694486344961285,"[8, 2, 12]",125.3297120549082,3.783454466394797,9,work_charger,57,68,57,"{57: 125.3297120549082, 58: 121.5462575885134, 59: 110.19589418932901, 60: 91.27862185735503, 61: 64.79444059259146, 62: 30.743350395038277, 63: 0, 64: 0, 65: 0, 66: 0, 67: 0}"
160,8,8,56.92367710179244,5,9,17,0.42694486344961285,"[14, 2, 8]",52.800531947245844,4.727154172204696,8,work_charger,200,209,200,"{200: 52.800531947245844, 201: 48.073377775041145, 202: 33.89191525842706, 203: 10.256144397403574, 204: 0, 205: 0, 206: 0, 207: 0, 208: 0}"
161,6,13,75.07273985455397,6,8,21,0.11261598827050798,"[4, 1, 13]",63.523982798472254,3.381493466195574,13,commuter,157,165,157,"{157: 63.523982798472254, 158: 60.14248933227668, 159: 49.99800893368996, 160: 33.090541602712086, 161: 9.42008733934307, 162: 0, 163: 0, 164: 0}"
161,7,8,59.38010040016167,8,10,18,0.19873409694795524,"[7, 9, 8]",80.34842085515608,3.2362451510610066,8,commuter,176,186,176,"{176: 80.34842085515608, 177: 77.11217570409507, 178: 67.40344025091206, 179: 51.22221449560702, 180: 28.568498438179972, 181: 0, 182: 0, 183: 0, 184: 0, 185: 0}"
161,6,15,42.77201366695147,5,7,22,0.11261598827050798,"[13, 4, 9]",62.80160652034363,2.898582893103554,15,commuter,159,166,159,"{159: 62.80160652034363, 160: 59.90302362724008, 161: 51.20727494792942, 162: 36.71436048241165, 163: 16.42428023068677, 164: 0, 165: 0}"
161,0,19,54.55465114259103,7,8,24,0.2384809163375463,"[14, 0, 4]",132.71867142453218,3.6823202033077416,19,commuter,19,27,19,"{19: 132.71867142453218, 20: 129.03635122122444, 21: 117.9893906113012, 22: 99.57778959476249, 23: 73.80154817160832, 24: 40.660666341838635, 25: 0.15514410545347346, 26: 0}"
162,9,12,23.189261353192542,2,6,18,0.2773860859525865,"[6, 9, 2]",77.33295831246629,3.561389385190948,12,work_charger,228,234,228,"{228: 77.33295831246629, 229: 73.77156892727534, 230: 63.0874007717025, 231: 45.28045384574776, 232: 20.35072814941112, 233: 0}"
162,2,8,27.949996629413842,3,7,15,0.41607912892887977,"[6, 13, 14]",86.22464520538495,3.60413319201275,8,work_charger,56,63,56,"{56: 86.22464520538495, 57: 82.62051201337219, 58: 71.80811243733395, 59: 53.787446477270194, 60: 28.558514133180942, 61: 0, 62: 0}"
162,5,14,15.16092978214887,1,4,18,0.23577817305969856,"[10, 14, 4]",119.89276609452169,4.997836268745608,14,work_charger,134,138,134,"{134: 119.89276609452169, 135: 114.89492982577607, 136: 99.90142101953926, 137: 74.91223967581121}"
162,4,11,24.090571602946568,2,5,16,0.2773860859525865,"[4, 0, 8]",114.72545113740756,2.493874287932196,11,work_charger,107,112,107,"{107: 114.72545113740756, 108: 112.23157684947536, 109: 104.74995398567877, 110: 92.2805825460178, 111: 74.82346253049244}"
163,11,19,65.168360962207,6,8,24,0.1385066336601369,"[10, 4, 11]",83.0267388322916,1.5028596311387048,19,commuter,283,291,283,"{283: 83.0267388322916, 284: 81.5238792011529, 285: 77.01530030773678, 286: 69.50100215204326, 287: 58.98098473407232, 288: 45.45524805382398, 289: 28.923792111298226, 290: 9.386616906495064}"
163,2,7,28.220313488010785,3,6,13,0.11542219471678075,"[8, 11, 2]",60.85553577726485,3.997161442197001,7,commuter,55,61,55,"{55: 60.85553577726485, 56: 56.85837433506785, 57: 44.866890008476844, 58: 24.881082797491842, 59: 0, 60: 0}"
163,6,19,36.97369982103724,4,7,24,0.11773063861111636,"[8, 2, 4]",102.13340857167344,2.1087254586984847,19,commuter,163,170,163,"{163: 102.13340857167344, 164: 100.02468311297496, 165: 93.69850673687951, 166: 83.15487944338707, 167: 68.39380123249768, 168: 49.415272104211326, 169: 26.219292058527998}"
163,0,8,76.52194617179488,6,9,17,0.11542219471678075,"[11, 0, 3]",106.04553467327162,2.2905113769470926,8,commuter,8,17,8,"{8: 106.04553467327162, 9: 103.75502329632452, 10: 96.88348916548324, 11: 85.43093228074778, 12: 69.39735264211814, 13: 48.7827502495943, 14: 23.587125103176277, 15: 0, 16: 0}"
163,12,18,75.7577814794985,4,7,24,0.11773063861111636,"[7, 9, 5]",69.19755058592378,2.952877436796954,18,commuter,306,313,306,"{306: 69.19755058592378, 307: 66.24467314912683, 308: 57.386040838735966, 309: 42.62165365475119, 310: 21.951511597172512, 311: 0, 312: 0}"
164,8,7,20.476233830490994,3,4,11,0.32552981030091777,"[1, 13, 7]",135.78009372825906,1.2326044822656046,7,commuter,199,203,199,"{199: 135.78009372825906, 200: 134.54748924599346, 201: 130.84967579919663, 202: 124.68665338786862}"
164,4,8,19.0946820260407,1,3,11,0.32552981030091777,"[5, 14, 13]",69.65869229108603,4.618553708459798,8,commuter,104,107,104,"{104: 69.65869229108603, 105: 65.04013858262623, 106: 51.184477457246835}"
164,12,12,17.59733345268642,2,5,17,0.1844668925038534,"[8, 13, 5]",60.354357195278396,2.8312546003384997,12,commuter,300,305,300,"{300: 60.354357195278396, 301: 57.5231025949399, 302: 49.029338793924396, 303: 34.8730657922319, 304: 15.0542835898624}"
165,12,18,23.022830459267645,2,3,21,0.14697100543459324,"[14, 2, 11]",76.08310800250088,4.196908425166107,18,commuter,306,309,306,"{306: 76.08310800250088, 307: 71.88619957733476, 308: 59.29547430183645}"
165,3,9,32.16931819915503,4,5,14,0.1440892210143071,"[9, 14, 3]",143.5752971471535,3.2625410748045756,9,commuter,81,86,81,"{81: 143.5752971471535, 82: 140.31275607234892, 83: 130.5251328479352, 84: 114.21242747391231, 85: 91.37463995028028}"
165,3,17,32.786900340477246,2,3,20,0.17290706521716856,"[3, 2, 9]",73.38483690854777,1.319660437386427,17,commuter,89,92,89,"{89: 73.38483690854777, 90: 72.06517647116134, 91: 68.10619515900206}"
165,9,9,28.338585979368766,2,4,13,0.1440892210143071,"[4, 6, 5]",115.05747911093461,2.424556648059873,9,commuter,225,229,225,"{225: 115.05747911093461, 226: 112.63292246287473, 227: 105.35925251869511, 228: 93.23646927839576}"
166,4,16,22.449846830594513,2,3,19,0.07656324989510772,"[8, 11, 10]",139.06785956054708,3.865324109026781,16,random,112,115,112,"{112: 139.06785956054708, 113: 135.2025354515203, 114: 123.60656312443996}"
166,8,14,67.17624291880053,6,8,22,0.07656324989510772,"[5, 13, 12]",74.16242717623842,3.7669828504436023,14,random,206,214,206,"{206: 74.16242717623842, 207: 70.39544432579483, 208: 59.094495774464015, 209: 40.259581522246, 210: 13.890701569140788, 211: 0, 212: 0, 213: 0}"
167,13,13,20.16503069038621,1,7,20,0.07331552924646118,"[9, 14, 13]",66.03659099049074,3.189953732597885,13,weekend_user,325,332,325,"{325: 66.03659099049074, 326: 62.84663725789285, 327: 53.276776060099195, 328: 37.32700739710977, 329: 14.997331268924576, 330: 0, 331: 0}"
167,6,10,56.87398617293998,8,11,21,0.07331552924646118,"[8, 2, 4]",78.89829042417996,3.954992116142491,10,weekend_user,154,165,154,"{154: 78.89829042417996, 155: 74.94329830803747, 156: 63.078321959609994, 157: 43.30336137889754, 158: 15.618416565900105, 159: 0, 160: 0, 161: 0, 162: 0, 163: 0, 164: 0}"
168,0,8,63.18765046954883,6,9,17,0.14525752927514315,"[13, 14, 0]",104.64668510006979,2.366809516436793,8,commuter,8,17,8,"{8: 104.64668510006979, 9: 102.279875583633, 10: 95.17944703432262, 11: 83.34539945213865, 12: 66.7777328370811, 13: 45.476447189149965, 14: 19.44154250834525, 15: 0, 16: 0}"
168,1,19,35.606601455585974,3,4,23,0.17430903513017182,"[8, 10, 12]",53.31334621932109,2.073513461108591,19,commuter,43,47,43,"{43: 53.31334621932109, 44: 51.2398327582125, 45: 45.019292374886724, 46: 34.65172506934377}"
168,12,16,27.742515017725225,3,6,22,0.08231259992258114,"[2, 14, 0]",66.70736563519982,4.896698034634787,16,commuter,304,310,304,"{304: 66.70736563519982, 305: 61.81066760056503, 306: 47.12057349666067, 307: 22.637083323486735, 308: 0, 309: 0}"
169,1,8,67.34102737861987,8,11,19,0.12789967286803822,"[9, 13, 5]",126.51902029810299,3.390748119774003,8,work_charger,32,43,32,"{32: 126.51902029810299, 33: 123.12827217832898, 34: 112.95602781900698, 35: 96.00228722013696, 36: 72.26705038171895, 37: 41.75031730375291, 38: 4.45208798623888, 39: 0, 40: 0, 41: 0, 42: 0}"
169,6,16,20.16125682047833,1,6,22,0.07247648129188833,"[9, 8, 14]",132.58634210423187,2.0587935108440263,16,work_charger,160,166,160,"{160: 132.58634210423187, 161: 130.52754859338785, 162: 124.35116806085577, 163: 114.05720050663564, 164: 99.64564593072745, 165: 81.11650433313122}"
169,5,14,30.748889087083754,5,7,21,0.07247648129188833,"[2, 6, 11]",78.01127023065654,4.348476500526653,14,work_charger,134,141,134,"{134: 78.01127023065654, 135: 73.66279373012988, 136: 60.617364228549924, 137: 38.87498172591666, 138: 8.43564622223009, 139: 0, 140: 0}"
170,0,16,38.606611574359384,4,7,23,0.0760379931275709,"[12, 2, 0]",134.33916463290706,4.767285075858907,16,random,16,23,16,"{16: 134.33916463290706, 17: 129.57187955704816, 18: 115.27002432947143, 19: 91.4335989501769, 20: 58.062603419164546, 21: 15.15703773643439, 22: 0}"
171,0,10,30.20625670373419,2,5,15,0.10474737843082378,"[7, 13, 3]",132.5973669583487,2.1652112348206014,10,work_charger,10,15,10,"{10: 132.5973669583487, 11: 130.4321557235281, 12: 123.93652201906627, 13: 113.11046584496327, 14: 97.95398720121906}"
171,9,9,30.193811247479537,3,8,17,0.15712106764623565,"[11, 7, 4]",61.69031422800484,2.9959490550992,9,work_charger,225,233,225,"{225: 61.69031422800484, 226: 58.694365172905634, 227: 49.70651800760804, 228: 34.72677273211204, 229: 13.75512934641764, 230: 0, 231: 0, 232: 0}"
171,13,19,39.908393329676244,3,8,24,0.16026348899916038,"[5, 10, 6]",81.77854085868638,2.240007411129221,19,work_charger,331,339,331,"{331: 81.77854085868638, 332: 79.53853344755716, 333: 72.8185112141695, 334: 61.6184741585234, 335: 45.938422280618845}"
172,6,10,42.50847029479642,6,9,19,0.09523615955246457,"[6, 0, 7]",63.0365024176891,2.3994923628006157,10,commuter,154,163,154,"{154: 63.0365024176891, 155: 60.637010054888485, 156: 53.43853296648663, 157: 41.44107115248356, 158: 24.644624612879248, 159: 3.0491933476737074, 160: 0, 161: 0, 162: 0}"
172,5,12,32.88370650077754,3,5,17,0.09523615955246457,"[11, 14, 9]",111.14342367394741,1.2757308084963563,12,commuter,132,137,132,"{132: 111.14342367394741, 133: 109.86769286545105, 134: 106.04050043996199, 135: 99.6618463974802, 136: 90.73173073800571}"
172,3,8,19.23946680306476,2,5,13,0.16806381097493747,"[11, 0, 13]",65.76360358329806,3.0570859817702045,8,commuter,80,85,80,"{80: 65.76360358329806, 81: 62.70651760152786, 82: 53.53525965621725, 83: 38.24982974736622, 84: 16.85022787497479}"
172,3,7,23.598836033333694,2,5,12,0.16806381097493747,"[5, 7, 6]",106.62048235071452,1.951696648979934,7,commuter,79,84,79,"{79: 106.62048235071452, 80: 104.66878570173459, 81: 98.8136957547948, 82: 89.05521250989511, 83: 75.39333596703558}"
172,0,8,40.001256798226905,3,4,12,0.16806381097493747,"[4, 13, 11]",126.85963944902751,2.508145432737011,8,commuter,8,12,8,"{8: 126.85963944902751, 9: 124.3514940162905, 10: 116.82705771807947, 11: 104.28633055439441}"
173,6,18,27.378897355195456,2,7,24,0.1591145421248195,"[14, 6, 9]",140.99296989772162,4.16355577274381,18,work_charger,162,169,162,"{162: 140.99296989772162, 163: 136.8294141249778, 164: 124.33874680674639, 165: 103.52096794302733, 166: 74.37607753382066, 167: 36.90407557912637, 168: 0}"
173,4,9,54.88753650026494,4,6,15,0.1559946491419799,"[1, 11, 8]",145.35735374122973,1.7325414862870794,9,work_charger,105,111,105,"{105: 145.35735374122973, 106: 143.62481225494264, 107: 138.4271877960814, 108: 129.764480364646, 109: 117.63668996063646, 110: 102.04381658405275}"
173,1,8,40.790661995118846,4,8,16,0.1559946491419799,"[11, 12, 13]",57.7271726267177,2.3730686282896163,8,work_charger,32,40,32,"{32: 57.7271726267177, 33: 55.35410399842809, 34: 48.23489811355924, 35: 36.36955497211116, 36: 19.758074574083842, 37: 0, 38: 0, 39: 0}"
173,2,10,27.521633068512322,2,7,17,0.10399643276131995,"[9, 7, 3]",80.35409079972989,3.4837843495030203,10,work_charger,58,65,58,"{58: 80.35409079972989, 59: 76.87030645022686, 60: 66.4189534017178, 61: 49.00003165420271, 62: 24.613541207681564, 63: 0, 64: 0}"
174,0,8,46.204158097647195,6,10,18,0.17320831755528485,"[13, 9, 12]",126.58523040370093,2.5165572630903696,8,work_charger,8,18,8,"{8: 126.58523040370093, 9: 124.06867314061057, 10: 116.51900135133945, 11: 103.93621503588761, 12: 86.32031419425502, 13: 63.67129882644169, 14: 35.989168932447626, 15: 3.2739245122728278, 16: 0, 17: 0}"
174,13,18,66.88158228808064,8,10,24,0.17667248390639056,"[0, 4, 8]",110.91206222132969,1.0259580855479888,18,work_charger,330,340,330,"{330: 110.91206222132969, 331: 109.88610413578171, 332: 106.80822987913774, 333: 101.6784394513978, 334: 94.49673285256188, 335: 85.26311008262996}"
174,11,10,25.13556222315146,4,7,17,0.11547221170352324,"[7, 1, 11]",120.98270749198761,3.109744339716912,10,work_charger,274,281,274,"{274: 120.98270749198761, 275: 117.8729631522707, 276: 108.54373013311996, 277: 92.9950084345354, 278: 71.22679805651703, 279: 43.23909899906481, 280: 9.031911262178781}"
175,5,16,42.454854344065126,6,8,24,0.08777161345666314,"[3, 2, 8]",141.99665228636425,4.967192280183065,16,commuter,136,144,136,"{136: 141.99665228636425, 137: 137.02946000618118, 138: 122.127883165632, 139: 97.29192176471668, 140: 62.52157580343521, 141: 17.81684528178762, 142: 0, 143: 0}"
175,9,17,37.64181491577598,5,8,24,0.18586929908469843,"[11, 10, 3]",52.23449337662912,4.234861587541759,17,commuter,233,241,233,"{233: 52.23449337662912, 234: 47.99963178908736, 235: 35.295047026462086, 236: 14.12073908875329, 237: 0, 238: 0, 239: 0, 240: 0}"
175,5,16,27.426539030679923,4,5,21,0.08777161345666314,"[12, 7, 4]",123.92651507258476,4.192808535925309,16,commuter,136,141,136,"{136: 123.92651507258476, 137: 119.73370653665945, 138: 107.15528092888353, 139: 86.19123824925698, 140: 56.84157849777982}"
175,12,14,31.173026767442735,3,5,19,0.08777161345666314,"[12, 3, 4]",73.32543218225484,3.0599296147832233,14,commuter,302,307,302,"{302: 73.32543218225484, 303: 70.26550256747161, 304: 61.08571372312195, 305: 45.78606564920584, 306: 24.36655834572327}"
176,6,15,42.04331359830658,3,6,21,0.10853250071914684,"[9, 14, 1]",98.22764594865788,1.1984509466477271,15,commuter,159,165,159,"{159: 98.22764594865788, 160: 97.02919500201016, 161: 93.43384216206697, 162: 87.44158742882834, 163: 79.05243080229425, 164: 68.2663722824647}"
176,11,18,53.012539206863536,3,4,22,0.22983353093466394,"[2, 8, 1]",78.88511233316314,1.8315522210525779,18,commuter,282,286,282,"{282: 78.88511233316314, 283: 77.05356011211056, 284: 71.55890344895282, 285: 62.40114234368993}"
176,7,7,31.024410610568086,3,6,13,0.19152794244555324,"[9, 1, 4]",62.952660990035234,4.371889608194253,7,commuter,175,181,175,"{175: 62.952660990035234, 176: 58.58077138184098, 177: 45.46510255725822, 178: 23.60565451628696, 179: 0, 180: 0}"
177,10,9,31.762264593167643,3,7,16,0.2718491918222675,"[14, 10, 12]",76.45910347687291,1.8402116807172209,9,work_charger,249,256,249,"{249: 76.45910347687291, 250: 74.6188917961557, 251: 69.09825675400403, 252: 59.89719835041792, 253: 47.01571658539738, 254: 30.45381145894239, 255: 10.211482971052959}"
177,7,9,41.499775073537165,3,5,14,0.2718491918222675,"[11, 10, 9]",149.7366181549704,4.921836683418309,9,work_charger,177,182,177,"{177: 149.7366181549704, 178: 144.81478147155207, 179: 130.04927142129714, 180: 105.4400880042056, 181: 70.98723122027744}"
177,11,10,41.80689248298517,4,8,18,0.18123279454817834,"[14, 7, 12]",130.55031112598633,3.924303526938194,10,work_charger,274,282,274,"{274: 130.55031112598633, 275: 126.62600759904814, 276: 114.85309701823356, 277: 95.23157938354258, 278: 67.76145469497521, 279: 32.44272295253147, 280: 0, 281: 0}"
177,4,11,20.772250852572277,2,5,16,0.18123279454817834,"[3, 7, 8]",147.76153675237532,3.711992060970338,11,work_charger,107,112,107,"{107: 147.76153675237532, 108: 144.04954469140498, 109: 132.91356850849397, 110: 114.35360820364228, 111: 88.3696637768499}"
178,13,12,37.789777712691006,3,8,20,0.18739780212151283,"[12, 11, 6]",92.92107795416997,4.589355862275075,12,weekend_user,324,332,324,"{324: 92.92107795416997, 325: 88.3317220918949, 326: 74.56365450506968, 327: 51.6168751936943, 328: 19.491384157768778, 329: 0, 330: 0, 331: 0}"
178,12,9,22.39774586557803,3,8,17,0.2810967031822692,"[0, 11, 12]",69.92367634855455,1.8057758585187274,9,weekend_user,297,305,297,"{297: 69.92367634855455, 298: 68.11790049003582, 299: 62.70057291447964, 300: 53.67169362188601, 301: 41.03126261225491, 302: 24.77927988558637, 303: 4.915745441880361, 304: 0}"
179,4,9,60.99786312138198,5,6,15,0.3734369154977967,"[5, 9, 11]",94.73684779918722,4.494376773166493,9,commuter,105,111,105,"{105: 94.73684779918722, 106: 90.24247102602072, 107: 76.75934070652124, 108: 54.287456840688776, 109: 22.826819428523322, 110: 0}"
179,13,11,40.19484772743595,2,5,16,0.21161425211541812,"[6, 10, 8]",87.44498775384349,4.9590976627203585,11,commuter,323,328,323,"{323: 87.44498775384349, 324: 82.48589009112314, 325: 67.60859710296205, 326: 42.813108789360264, 327: 8.099425150317757}"
179,7,18,86.96176244464895,5,8,24,0.44812429859735603,"[9, 3, 14]",96.4195622421631,3.3894562998422035,18,commuter,186,194,186,"{186: 96.4195622421631, 187: 93.03010594232089, 188: 82.86173704279429, 189: 65.91445554358327, 190: 42.18826144468784, 191: 11.683154746108002, 192: 0, 193: 0}"
180,7,19,44.00891863051541,3,9,24,0.30168485102089604,"[8, 1, 4]",102.03722164409679,4.409400466735336,19,night_charger,187,196,187,"{187: 102.03722164409679, 188: 97.62782117736145, 189: 84.39961977715544, 190: 62.35261744347876, 191: 31.486814176331407, 192: 0, 193: 0, 194: 0, 195: 0}"
180,10,19,55.923244551291674,4,11,24,0.30168485102089604,"[1, 6, 0]",71.10558892668506,2.7299335034906393,19,night_charger,259,270,259,"{259: 71.10558892668506, 260: 68.37565542319442, 261: 60.185854912722505, 262: 46.53618739526931, 263: 27.42665287083483, 264: 2.8572513394190793, 265: 0, 266: 0, 267: 0, 268: 0, 269: 0}"
181,5,11,29.422904810988598,2,8,19,0.22400436129146453,"[13, 2, 12]",50.03097319150059,4.529124380181532,11,weekend_user,131,139,131,"{131: 50.03097319150059, 132: 45.501848811319064, 133: 31.914475670774465, 134: 9.268853769866809, 135: 0, 136: 0, 137: 0, 138: 0}"
182,0,9,32.953055080877895,4,7,16,0.1665733646214937,"[11, 7, 2]",126.7506695395364,1.28501074128546,9,work_charger,9,16,9,"{9: 126.7506695395364, 10: 125.46565879825094, 11: 121.61062657439456, 12: 115.18557286796727, 13: 106.19049767896905, 14: 94.62540100739992, 15: 80.49028285325986}"
182,10,8,63.792011528918835,5,8,16,0.1665733646214937,"[6, 12, 14]",87.61651104310778,3.0250069379893074,8,work_charger,248,256,248,"{248: 87.61651104310778, 249: 84.59150410511847, 250: 75.51648329115055, 251: 60.39144860120401, 252: 39.21640003527886, 253: 11.991337593375093, 254: 0, 255: 0}"
182,4,13,35.54417965485712,5,10,23,0.11104890974766246,"[7, 8, 12]",141.77956261106797,3.667024245229509,13,work_charger,109,119,109,"{109: 141.77956261106797, 110: 138.11253836583847, 111: 127.11146563014994, 112: 108.77634440400239, 113: 83.10717468739583, 114: 50.10395648033024, 115: 9.766689782805628, 116: 0, 117: 0, 118: 0}"
183,12,19,37.93367607764963,5,11,24,0.2479090651263802,"[0, 5, 9]",116.53777091515077,4.850947645589027,19,weekend_user,307,318,307,"{307: 116.53777091515077, 308: 111.68682326956174, 309: 97.13398033279466, 310: 72.87924210484952, 311: 38.92260858572634, 312: 0, 313: 0, 314: 0, 315: 0, 316: 0, 317: 0}"
183,12,12,48.91797846247084,3,9,21,0.13772725840354458,"[5, 13, 9]",84.87172148570153,4.5363427863058465,12,weekend_user,300,309,300,"{300: 84.87172148570153, 301: 80.33537869939568, 302: 66.72635034047815, 303: 44.04463640894891, 304: 12.290236904807983, 305: 0, 306: 0, 307: 0, 308: 0}"
184,3,13,44.8902710110922,3,5,18,0.08636562007598658,"[8, 3, 5]",59.668971633774305,1.9058424150322195,13,work_charger,85,90,85,"{85: 59.668971633774305, 86: 57.76312921874209, 87: 52.045601973645425, 88: 42.516389898484334, 89: 29.175492993258793}"
184,13,17,61.430170737451334,6,10,24,0.13213939871625946,"[14, 9, 0]",149.6762584986409,1.3958092067461396,17,work_charger,329,339,329,"{329: 149.6762584986409, 330: 148.28044929189474, 331: 144.09302167165635, 332: 137.11397563792565, 333: 127.34331119070265, 334: 114.78102832998741, 335: 99.42712705577986}"
184,1,9,36.16441088385211,3,5,14,0.12954843011397987,"[3, 5, 14]",129.86130159234511,2.8341950859176004,9,work_charger,33,38,33,"{33: 129.86130159234511, 34: 127.02710650642751, 35: 118.52452124867472, 36: 104.35354581908672, 37: 84.51418021766351}"
185,10,15,48.22054987008589,6,9,24,0.24535409368144545,"[9, 12, 3]",114.88483286945149,3.4766374908808033,15,random,255,264,255,"{255: 114.88483286945149, 256: 111.40819537857068, 257: 100.97828290592827, 258: 83.59509545152426, 259: 59.25863301535863, 260: 27.9688955974314, 261: 0, 262: 0, 263: 0}"
185,8,12,38.2105327608754,6,9,21,0.24535409368144545,"[2, 11, 13]",73.46835328852502,1.4538420060990762,12,random,204,213,204,"{204: 73.46835328852502, 205: 72.01451128242594, 206: 67.65298526412872, 207: 60.38377523363334, 208: 50.206881190939804, 209: 37.12230313604812, 210: 21.130041068958278, 211: 2.2300949896702917, 212: 0}"
186,12,13,22.709071432822995,2,3,16,0.15187118856362064,"[11, 13, 0]",69.22917232310797,1.2741039503879525,13,commuter,301,304,301,"{301: 69.22917232310797, 302: 67.95506837272002, 303: 64.13275652155616}"
186,1,8,29.992538861974058,3,4,12,0.26800797981815405,"[4, 1, 11]",79.90802116554113,2.8094967080932025,8,commuter,32,36,32,"{32: 79.90802116554113, 33: 77.09852445744792, 34: 68.67003433316832, 35: 54.622550792702306}"
186,7,9,27.999149866612342,2,5,14,0.26800797981815405,"[5, 7, 12]",56.75012288723875,1.868658063825769,9,commuter,177,182,177,"{177: 56.75012288723875, 178: 54.88146482341298, 179: 49.275490631935675, 180: 39.93220031280683, 181: 26.851593866026448}"
186,12,17,18.64706969068019,3,6,23,0.27336813941451715,"[12, 2, 6]",67.68632120939156,3.6485093954169954,17,commuter,305,311,305,"{305: 67.68632120939156, 306: 64.03781181397457, 307: 53.09228362772358, 308: 34.849736650638604, 309: 9.310170882719639, 310: 0}"
187,8,9,21.141416381270012,3,4,13,0.14103318347235824,"[6, 0, 7]",58.45433353801231,4.941378874749242,9,commuter,201,205,201,"{201: 58.45433353801231, 202: 53.512954663263066, 203: 38.68881803901534, 204: 13.981923665269129}"
187,13,17,36.41695229842213,5,7,24,0.1438538471418054,"[13, 5, 4]",53.50876112163,3.605601434803667,17,commuter,329,336,329,"{329: 53.50876112163, 330: 49.903159686826335, 331: 39.086355382415334, 332: 21.058348208397, 333: 0, 334: 0, 335: 0}"
187,10,18,14.876297202903416,1,3,21,0.16923982016682992,"[5, 9, 13]",129.73732687744774,2.5264442954686417,18,commuter,258,261,258,"{258: 129.73732687744774, 259: 127.2108825819791, 260: 119.63154969557317}"
187,0,17,38.76422958943372,4,6,23,0.16923982016682992,"[2, 5, 7]",109.26639501334947,2.94482825958652,17,commuter,17,23,17,"{17: 109.26639501334947, 18: 106.32156675376295, 19: 97.48708197500339, 20: 82.76294067707079, 21: 62.149142859965146, 22: 35.64568852368646}"
187,4,17,21.212175972338578,2,5,22,0.16923982016682992,"[13, 0, 1]",82.50515236095876,1.931118737749916,17,commuter,113,118,113,"{113: 82.50515236095876, 114: 80.57403362320885, 115: 74.7806774099591, 116: 65.12508372120952, 117: 51.607252556960105}"
188,7,20,18.56770895684555,3,11,24,0.19310370255074027,"[3, 5, 6]",143.30148731304206,4.0228565344043385,20,night_charger,188,199,188,"{188: 143.30148731304206, 189: 139.27863077863773, 190: 127.2100611754247, 191: 107.09577850340301, 192: 78.93578276257264, 193: 42.730073952933594, 194: 0, 195: 0, 196: 0, 197: 0, 198: 0}"
188,3,22,29.932089728344994,4,10,24,0.10727983475041127,"[6, 1, 8]",60.590633617477785,3.4766400986508175,22,night_charger,94,104,94,"{94: 60.590633617477785, 95: 57.113993518826966, 96: 46.68407322287452, 97: 29.300872729620426, 98: 4.964392039064705, 99: 0, 100: 0, 101: 0, 102: 0, 103: 0}"
188,5,23,27.61623324089863,2,10,24,0.06383150167649469,"[14, 1, 3]",78.83414277946858,2.9747634198774002,23,night_charger,143,153,143,"{143: 78.83414277946858, 144: 75.85937935959117, 145: 66.93508909995897, 146: 52.061272000571975, 147: 31.237928061430175, 148: 4.465057282533579, 149: 0, 150: 0, 151: 0, 152: 0}"
189,2,19,46.95467779075529,4,9,24,0.45246070234620595,"[14, 4, 8]",120.42914023816463,3.9688873420968416,19,night_charger,67,76,67,"{67: 120.42914023816463, 68: 116.4602528960678, 69: 104.55359086977727, 70: 84.70915415929306, 71: 56.92694276461517, 72: 21.20695668574359, 73: 0, 74: 0, 75: 0}"
189,2,23,30.62404564920085,3,9,24,0.17595693980130228,"[1, 0, 13]",142.10343865453382,1.201668022520677,23,night_charger,71,80,71,"{71: 142.10343865453382, 72: 140.90177063201315, 73: 137.2967665644511, 74: 131.28842645184773, 75: 122.87675029420299, 76: 112.06173809151689, 77: 98.84338984378945, 78: 83.22170555102065, 79: 65.19668521321049}"
189,12,22,51.84515370459833,5,10,24,0.21366199833015279,"[2, 13, 0]",71.16708270045032,1.3228932183316577,22,night_charger,310,320,310,"{310: 71.16708270045032, 311: 69.84418948211867, 312: 65.8755098271237, 313: 59.26104373546541, 314: 50.0007912071438, 315: 38.094752242158876, 316: 23.542926840510646, 317: 6.3453150021990865, 318: 0, 319: 0}"
190,9,19,25.326654295689657,2,3,22,0.1486899436475184,"[11, 4, 5]",109.99442914044707,1.9509174491130143,19,commuter,235,238,235,"{235: 109.99442914044707, 236: 108.04351169133405, 237: 102.19075934399501}"
190,3,8,63.71461888498772,5,7,15,0.12390828637293198,"[13, 7, 1]",65.91675344798145,3.629885475424614,8,commuter,80,87,80,"{80: 65.91675344798145, 81: 62.286867972556834, 82: 51.39721154628299, 83: 33.24778416915992, 84: 7.838585841187623, 85: 0, 86: 0}"
190,4,9,61.57124215432605,6,9,18,0.12390828637293198,"[2, 10, 8]",102.05998168029811,1.2948392746889752,9,commuter,105,114,105,"{105: 102.05998168029811, 106: 100.76514240560914, 107: 96.88062458154221, 108: 90.40642820809734, 109: 81.3425532852745, 110: 69.68899981307374, 111: 55.445767791495, 112: 38.612857220538324, 113: 19.190268100203696}"
191,1,13,83.45904818059967,6,9,22,0.08260400221117664,"[0, 8, 7]",139.0312490948142,4.004976120739486,13,work_charger,37,46,37,"{37: 139.0312490948142, 38: 135.02627297407471, 39: 123.01134461185626, 40: 102.98646400815883, 41: 74.95163116298242, 42: 38.90684607632704, 43: 0, 44: 0, 45: 0}"
191,3,8,54.052647599002164,6,10,18,0.12390600331676496,"[5, 0, 6]",54.466002887722375,2.340497066784899,8,work_charger,80,90,80,"{80: 54.466002887722375, 81: 52.12550582093748, 82: 45.10401462058278, 83: 33.40152928665829, 84: 17.01804981916399, 85: 0, 86: 0, 87: 0, 88: 0, 89: 0}"
191,9,12,79.43908965164027,6,8,20,0.08260400221117664,"[6, 14, 11]",149.33675008820887,4.873193258640677,12,work_charger,228,236,228,"{228: 149.33675008820887, 229: 144.4635568295682, 230: 129.84397705364617, 231: 105.47801076044277, 232: 71.36565794995803, 233: 27.506918622191932, 234: 0, 235: 0}"
192,1,20,50.05166819818568,3,9,24,0.27118998005587863,"[10, 11, 3]",137.56993729425653,2.839289723636716,20,night_charger,44,53,44,"{44: 137.56993729425653, 45: 134.73064757061982, 46: 126.21277839970966, 47: 112.01632978152608, 48: 92.14130171606908, 49: 66.58769420333864, 50: 35.355507243334756, 51: 0, 52: 0}"
192,6,22,52.87193882432202,3,8,24,0.12806193502638713,"[12, 14, 5]",80.96552743804611,1.1226379606007892,22,night_charger,166,174,166,"{166: 80.96552743804611, 167: 79.84288947744533, 168: 76.47497559564295, 169: 70.86178579263901, 170: 63.00332006843348, 171: 52.89957842302638, 172: 40.5505608564177, 173: 25.956267368607435}"
193,8,19,56.051149267538406,3,6,24,0.2671657018465453,"[4, 11, 14]",129.70839554491036,2.36734183504401,19,random,211,217,211,"{211: 129.70839554491036, 212: 127.34105370986634, 213: 120.23902820473432, 214: 108.40231902951427, 215: 91.83092618420619, 216: 70.5248496688101}"
193,1,7,21.006567050306828,3,4,11,0.22263808487212106,"[11, 6, 14]",93.45026937193043,1.0978588110357337,7,random,31,35,31,"{31: 93.45026937193043, 32: 92.3524105608947, 33: 89.05883412778749, 34: 83.56954007260883}"
193,0,7,61.558122091001735,4,6,13,0.22263808487212106,"[3, 1, 6]",107.189896766037,4.858742225787367,7,random,7,13,7,"{7: 107.189896766037, 8: 102.33115454024963, 9: 87.75492786288753, 10: 63.46121673395069, 11: 29.450021153439124, 12: 0}"
194,10,18,16.77211737601203,2,6,24,0.1361200956833836,"[4, 1, 11]",56.98163014855619,3.226782683283413,18,random,258,264,258,"{258: 56.98163014855619, 259: 53.75484746527278, 260: 44.07449941542254, 261: 27.940585999005474, 262: 5.353107216021584, 263: 0}"
194,9,17,57.810577271551146,4,5,22,0.1361200956833836,"[10, 9, 14]",131.7777883971628,4.475888660256008,17,random,233,238,233,"{233: 131.7777883971628, 234: 127.30189973690679, 235: 113.87423375613876, 236: 91.49479045485872, 237: 60.16356983306666}"
195,10,16,42.79874855705837,3,6,22,0.10421991599516581,"[7, 5, 2]",102.78742078895624,3.377014268799675,16,random,256,262,256,"{256: 102.78742078895624, 257: 99.41040652015657, 258: 89.27936371375753, 259: 72.39429236975917, 260: 48.75519248816144, 261: 18.362064068964372}"
195,12,21,38.94781688070138,5,6,24,0.08858692859589094,"[6, 7, 13]",54.64488172857615,1.6341661423664418,21,random,309,315,309,"{309: 54.64488172857615, 310: 53.01071558620971, 311: 48.10821715911038, 312: 39.93738644727817, 313: 28.498223450713084, 314: 13.790728169415111}"
196,6,12,28.872519413881257,3,4,16,0.09830568942615432,"[6, 5, 13]",74.94512669524323,2.2663778136391186,12,commuter,156,160,156,"{156: 74.94512669524323, 157: 72.67874888160411, 158: 65.87961544068676, 159: 54.54772637249117}"
196,11,7,34.02560750480103,3,4,11,0.17348062839909587,"[5, 13, 10]",143.0254319985056,4.6303028158530655,7,commuter,271,275,271,"{271: 143.0254319985056, 272: 138.39512918265254, 273: 124.50422073509336, 274: 101.35270665582803}"
196,12,19,23.84508927199913,3,6,24,0.1769502409670778,"[9, 4, 1]",92.2823362889921,4.856889112349112,19,commuter,307,313,307,"{307: 92.2823362889921, 308: 87.42544717664299, 309: 72.85477983959565, 310: 48.570334277850094, 311: 14.572110491406306, 312: 0}"
196,1,17,39.093129959313934,5,7,24,0.20817675407891506,"[11, 10, 4]",138.74074739689635,4.903327559130829,17,commuter,41,48,41,"{41: 138.74074739689635, 42: 133.83741983776554, 43: 119.12743716037303, 44: 94.6107993647189, 45: 60.28750645080309, 46: 16.15755841862564, 47: 0}"
197,5,11,40.91981121022214,2,5,16,0.07255744844887008,"[7, 6, 1]",75.2707859709125,1.7914185987106577,11,commuter,131,136,131,"{131: 75.2707859709125, 132: 73.47936737220184, 133: 68.10511157606987, 134: 59.148018582516585, 135: 46.608088391541976}"
197,13,13,63.48847929849018,5,7,20,0.07255744844887008,"[12, 9, 5]",91.84339600772948,4.205773074912457,13,commuter,325,332,325,"{325: 91.84339600772948, 326: 87.63762293281702, 327: 75.02030370807965, 328: 53.991438333517365, 329: 24.551026809130164, 330: 0, 331: 0}"
197,12,14,62.080468852553494,4,5,19,0.07255744844887008,"[4, 13, 9]",120.91571657014643,4.440481765589654,14,commuter,302,307,302,"{302: 120.91571657014643, 303: 116.47523480455678, 304: 103.15378950778782, 305: 80.95138067983954, 306: 49.868008320711965}"
197,11,8,39.17198054700403,6,8,16,0.1280425560862413,"[6, 3, 10]",81.22318396207352,4.638154279653555,8,commuter,272,280,272,"{272: 81.22318396207352, 273: 76.58502968241997, 274: 62.6705668434593, 275: 39.47979544519153, 276: 7.012715487616646, 277: 0, 278: 0, 279: 0}"
197,8,8,23.14375112099687,4,5,13,0.1280425560862413,"[14, 10, 13]",127.48652675011076,3.1588220613065228,8,commuter,200,205,200,"{200: 127.48652675011076, 201: 124.32770468880423, 202: 114.85123850488466, 203: 99.05712819835205, 204: 76.94537376920638}"
198,0,8,37.466499637651694,4,6,14,0.2424737475532771,"[9, 3, 5]",73.09630043006247,2.5967230599555644,8,commuter,8,14,8,"{8: 73.09630043006247, 9: 70.4995773701069, 10: 62.70940819024021, 11: 49.72579289046239, 12: 31.54873147077344, 13: 8.178223931173363}"
198,8,17,37.68732196275839,3,5,22,0.2909684970639326,"[10, 3, 11]",148.05921238047873,4.218234857874521,17,commuter,209,214,209,"{209: 148.05921238047873, 210: 143.8409775226042, 211: 131.18627294898064, 212: 110.09509865960804, 213: 80.5674546544864}"
198,4,8,27.658956626821716,3,5,13,0.2424737475532771,"[3, 13, 2]",132.26249276785603,1.6078501035128605,8,commuter,104,109,104,"{104: 132.26249276785603, 105: 130.65464266434316, 106: 125.83109235380459, 107: 117.79184183624028, 108: 106.53689111165026}"
198,6,13,17.47864384255496,1,4,17,0.1374017902801904,"[12, 5, 3]",120.62888140390073,3.5558226541374376,13,commuter,157,161,157,"{157: 120.62888140390073, 158: 117.07305874976329, 159: 106.40559078735099, 160: 88.6264775166638}"
198,11,19,41.715325111809236,2,4,23,0.2909684970639326,"[6, 10, 11]",54.5920056091263,2.3549779769746886,19,commuter,283,287,283,"{283: 54.5920056091263, 284: 52.237027632151616, 285: 45.17209370122755, 286: 33.39720381635411}"
199,4,8,46.124823419030726,4,6,14,0.19671720254201924,"[0, 6, 12]",81.45571160256279,3.533308529460332,8,commuter,104,110,104,"{104: 81.45571160256279, 105: 77.92240307310246, 106: 67.32247748472146, 107: 49.6559348374198, 108: 24.922775131197476, 109: 0}"
199,3,17,44.94194226870446,3,4,21,0.23606064305042315,"[1, 13, 6]",106.68191233856312,4.728910792737853,17,commuter,89,93,89,"{89: 106.68191233856312, 90: 101.95300154582527, 91: 87.76626916761171, 92: 64.12171520392245}"
199,5,15,30.165483622528136,4,5,20,0.11147308144047759,"[9, 3, 10]",79.1653185394699,4.166130474667568,15,commuter,135,140,135,"{135: 79.1653185394699, 136: 74.99918806480233, 137: 62.50079664079962, 138: 41.67014426746178, 139: 12.507230944788802}"
199,4,17,44.21155405301441,3,5,22,0.23606064305042315,"[12, 11, 3]",131.7080387441693,3.943977469594812,17,commuter,113,118,113,"{113: 131.7080387441693, 114: 127.76406127457449, 115: 115.93212886579005, 116: 96.21224151781598, 117: 68.6043992306523}"
200,0,10,37.57675844690998,4,7,17,0.16635890025525626,"[10, 5, 11]",88.7930537654872,1.0007020634316932,10,random,10,17,10,"{10: 88.7930537654872, 11: 87.79235170205551, 12: 84.79024551176043, 13: 79.78673519460196, 14: 72.78182075058011, 15: 63.77550217969487, 16: 52.76777948194625}"
201,11,19,15.022460268200525,2,5,24,0.1603571788786446,"[7, 11, 13]",134.59888773872314,2.252036876787573,19,random,283,288,283,"{283: 134.59888773872314, 284: 132.34685086193556, 285: 125.59074023157284, 286: 114.33055584763497, 287: 98.56629771012197}"
202,13,14,35.731694041705225,4,6,20,0.09374834434545128,"[11, 3, 9]",138.38572635999594,4.642710959673218,14,commuter,326,332,326,"{326: 138.38572635999594, 327: 133.74301540032272, 328: 119.81488252130308, 329: 96.60132772293699, 330: 64.10235100522445, 331: 22.31795236816548}"
202,3,7,22.089100666943636,4,6,13,0.16543825472726695,"[11, 0, 4]",105.79923148934525,4.704696176279015,7,commuter,79,85,79,"{79: 105.79923148934525, 80: 101.09453531306623, 81: 86.98044678422919, 82: 63.45696590283411, 83: 30.52409266888101, 84: 0}"
202,4,19,22.911115579199844,2,4,23,0.19852590567272038,"[5, 7, 0]",123.17720250869874,4.006868165913934,19,commuter,115,119,115,"{115: 123.17720250869874, 116: 119.17033434278481, 117: 107.149729845043, 118: 87.11538901547334}"
202,3,18,7.51819619643188,2,3,21,0.19852590567272038,"[0, 5, 10]",100.65986961834594,4.5618650304975645,18,commuter,90,93,90,"{90: 100.65986961834594, 91: 96.09800458784838, 92: 82.41240949635568}"
203,7,13,43.665398916716796,3,8,21,0.10079035731584228,"[6, 4, 1]",129.33097732158208,4.300365843191372,13,work_charger,181,189,181,"{181: 129.33097732158208, 182: 125.03061147839071, 183: 112.1295139488166, 184: 90.62768473285973, 185: 60.52512383052013, 186: 21.82183124179778, 187: 0, 188: 0}"
203,13,10,38.03583990436935,3,5,15,0.08567180371846594,"[12, 5, 2]",50.344614377686966,2.320724092611519,10,work_charger,322,327,322,"{322: 50.344614377686966, 323: 48.023890285075446, 324: 41.06171800724089, 325: 29.458097544183293, 326: 13.21302889590266}"
203,2,9,38.80089716912245,2,4,13,0.1511855359737634,"[1, 2, 8]",102.92555409507501,4.79576052513704,9,work_charger,57,61,57,"{57: 102.92555409507501, 58: 98.12979356993797, 59: 83.74251199452685, 60: 59.76370936884165}"
203,1,9,47.45658605556434,4,7,16,0.1511855359737634,"[10, 8, 3]",85.37959854689052,3.5542909508225295,9,work_charger,33,40,33,"{33: 85.37959854689052, 34: 81.82530759606799, 35: 71.1624347436004, 36: 53.390979989487754, 37: 28.510943333730047, 38: 0, 39: 0}"
204,9,9,87.42026415160888,7,8,17,0.25612979071116754,"[7, 8, 14]",54.550423779029614,4.803872745809597,9,commuter,225,233,225,"{225: 54.550423779029614, 226: 49.746551033220015, 227: 35.334932795791225, 228: 11.315569066743237, 229: 0, 230: 0, 231: 0, 232: 0}"
204,5,13,65.52450005169017,5,6,19,0.1451402147363283,"[4, 8, 13]",82.23550934061763,3.608058461356525,13,commuter,133,139,133,"{133: 82.23550934061763, 134: 78.6274508792611, 135: 67.80327549519153, 136: 49.762983188408896, 137: 24.506573958913222, 138: 0}"
204,9,8,45.443476026253954,3,4,12,0.25612979071116754,"[10, 14, 11]",90.52567805721077,3.993101497589027,8,commuter,224,228,224,"{224: 90.52567805721077, 225: 86.53257655962175, 226: 74.55327206685466, 227: 54.58776457890953}"
204,5,18,66.79970295270954,5,6,24,0.2612523865253909,"[5, 1, 8]",134.58996459615253,2.62654022249221,18,commuter,138,144,138,"{138: 134.58996459615253, 139: 131.9634243736603, 140: 124.08380370618369, 141: 110.95110259372264, 142: 92.56532103627717, 143: 68.92645903384728}"
205,5,20,30.35867872086402,2,5,24,0.2763934846395719,"[10, 11, 9]",89.28077169525389,2.5794146976147134,20,weekend_user,140,145,140,"{140: 89.28077169525389, 141: 86.70135699763918, 142: 78.96311290479504, 143: 66.06603941672147, 144: 48.010136533418475}"
206,6,18,39.03520857720529,2,8,24,0.18619753856189472,"[6, 2, 4]",131.99798080824368,2.5361895310300975,18,weekend_user,162,170,162,"{162: 131.99798080824368, 163: 129.4617912772136, 164: 121.8532226841233, 165: 109.1722750289728, 166: 91.41894831176212, 167: 68.59324253249125, 168: 40.695157691160176, 169: 7.724693787768899}"
206,6,12,53.0027071660931,3,8,20,0.10344307697883041,"[14, 10, 11]",74.5803856277866,3.6954615756787526,12,weekend_user,156,164,156,"{156: 74.5803856277866, 157: 70.88492405210785, 158: 59.79853932507159, 159: 41.32123144667783, 160: 15.453000416926557, 161: 0, 162: 0, 163: 0}"
207,2,18,17.66076085561117,1,4,22,0.1680830649254116,"[11, 6, 1]",126.85001073627778,1.674804115760975,18,commuter,66,70,66,"{66: 126.85001073627778, 67: 125.1752066205168, 68: 120.15079427323388, 69: 111.77677369442901}"
207,2,9,30.092135870348375,3,6,15,0.14006922077117634,"[7, 13, 5]",122.45220023342928,2.203946037047134,9,commuter,57,63,57,"{57: 122.45220023342928, 58: 120.24825419638215, 59: 113.63641608524074, 60: 102.61668590000508, 61: 87.18906364067513, 62: 67.35354930725093}"
207,3,18,23.881782388062472,2,5,23,0.1680830649254116,"[1, 9, 14]",81.07042187179171,3.3225832014398016,18,commuter,90,95,90,"{90: 81.07042187179171, 91: 77.74783867035191, 92: 67.7800890660325, 93: 51.1671730588335, 94: 27.909090648754884}"
208,12,18,53.36773076000111,5,6,24,0.17820264998976987,"[2, 7, 6]",97.095685239103,4.203306305767509,18,random,306,312,306,"{306: 97.095685239103, 307: 92.8923789333355, 308: 80.28246001603297, 309: 59.265928487195424, 310: 29.842784346822867, 311: 0}"
208,4,20,58.48532556527376,4,6,24,0.20965017645855283,"[1, 13, 7]",112.520832174293,2.961641444547221,20,random,116,122,116,"{116: 112.520832174293, 117: 109.55919072974578, 118: 100.67426639610412, 119: 85.86605917336801, 120: 65.13456906153746, 121: 38.479796060612486}"
209,6,15,36.6382869664877,4,6,21,0.23225375629014486,"[14, 11, 1]",67.77044611968141,4.148491451757767,15,commuter,159,165,159,"{159: 67.77044611968141, 160: 63.621954667923646, 161: 51.17648031265034, 162: 30.43402305386151, 163: 1.3945828915571354, 164: 0}"
209,10,9,59.41002369468843,3,6,15,0.40985956992378497,"[13, 1, 9]",130.80989804935118,4.342298758308379,9,commuter,249,255,249,"{249: 130.80989804935118, 250: 126.4675992910428, 251: 113.44070301611765, 252: 91.72920922457575, 253: 61.33311791641711, 254: 22.2524290916417}"
209,2,18,49.11779940857192,3,5,23,0.4918314839085421,"[9, 12, 0]",95.06210479302757,4.0342209138671645,18,commuter,66,71,66,"{66: 95.06210479302757, 67: 91.02788387916041, 68: 78.9252211375589, 69: 58.75411656822309, 70: 30.51457017115294}"
209,5,13,38.63233344462405,5,6,19,0.23225375629014486,"[5, 8, 1]",63.00069552327699,3.7764301289226756,13,commuter,133,139,133,"{133: 63.00069552327699, 134: 59.22426539435431, 135: 47.89497500758628, 136: 29.012824362972907, 137: 2.5778134605141787, 138: 0}"
209,6,14,35.74726164347146,2,4,18,0.23225375629014486,"[9, 8, 12]",112.74456098169422,1.0010098179622484,14,commuter,158,162,158,"{158: 112.74456098169422, 159: 111.74355116373198, 160: 108.74052170984523, 161: 103.73547262003399}"
210,11,16,70.75593701532938,4,8,24,0.08320264695976991,"[13, 0, 4]",149.68149760709497,3.930687880002674,16,random,280,288,280,"{280: 149.68149760709497, 281: 145.7508097270923, 282: 133.95874608708428, 283: 114.3053066870709, 284: 86.79049152705218, 285: 51.41430060702811, 286: 8.176733926998708, 287: 0}"
210,0,20,54.43841052234052,6,7,24,0.14976476452758586,"[1, 14, 10]",135.05221096049746,1.1926031566928037,20,random,20,27,20,"{20: 135.05221096049746, 21: 133.85960780380466, 22: 130.28179833372624, 23: 124.31878255026223, 24: 115.9705604534126, 25: 105.23713204317737, 26: 92.11849731955652}"
210,10,12,63.29552725712654,8,10,22,0.08320264695976991,"[2, 3, 0]",86.44268113352511,2.5196381792964813,12,random,252,262,252,"{252: 86.44268113352511, 253: 83.92304295422863, 254: 76.36412841633918, 255: 63.76593751985678, 256: 46.12847026478141, 257: 23.451726651113084, 258: 0, 259: 0, 260: 0, 261: 0}"
211,3,23,25.618118275714632,2,10,24,0.17587045903235102,"[10, 0, 3]",112.6947855241755,3.565467276901209,23,night_charger,95,105,95,"{95: 112.6947855241755, 96: 109.1293182472743, 97: 98.43291641657066, 98: 80.60558003206462, 99: 55.64730909375616, 100: 23.55810360164527, 101: 0, 102: 0, 103: 0, 104: 0}"
211,9,19,70.89009948722632,5,12,24,0.4522383232260455,"[6, 3, 10]",71.12547308105817,1.751506155764584,19,night_charger,235,247,235,"{235: 71.12547308105817, 236: 69.37396692529359, 237: 64.11944845799984, 238: 55.36191767917692, 239: 43.10137458882483, 240: 27.337819186943577, 241: 8.071251473533152, 242: 0, 243: 0, 244: 0, 245: 0, 246: 0}"
212,6,17,24.104239947543647,2,3,20,0.11868213338660692,"[6, 8, 4]",85.34365544904344,1.8553410226685223,17,commuter,161,164,161,"{161: 85.34365544904344, 162: 83.48831442637491, 163: 77.92229135836935}"
212,11,7,32.25389157851379,2,5,12,0.11635503273196758,"[3, 5, 9]",64.2001818804398,3.592348448433825,7,commuter,271,276,271,"{271: 64.2001818804398, 272: 60.607833432005975, 273: 49.8307880867045, 274: 31.86904584453537, 275: 6.722606705498599}"
212,5,13,37.23740221303584,4,5,18,0.06593451854811497,"[3, 5, 0]",145.3769396212827,2.6635608528487804,13,commuter,133,138,133,"{133: 145.3769396212827, 134: 142.71337876843393, 135: 134.72269620988757, 136: 121.40489194564367, 137: 102.75996597570222}"
212,5,10,34.27865652555781,2,5,15,0.06593451854811497,"[10, 4, 12]",99.32935805626923,2.993407565241842,10,commuter,130,135,130,"{130: 99.32935805626923, 131: 96.33595049102739, 132: 87.35572779530186, 133: 72.38868996909265, 134: 51.434837012399754}"
213,5,18,23.31047822817569,3,7,24,0.42680765893956313,"[3, 6, 1]",52.07678867103912,2.5820885450056767,18,random,138,145,138,"{138: 52.07678867103912, 139: 49.49470012603344, 140: 41.74843449101641, 141: 28.83799176598803, 142: 10.76337195094829, 143: 0, 144: 0}"
214,4,8,24.565523569441307,3,6,14,0.14594509228270708,"[0, 11, 12]",111.94215539345466,3.9948945411866505,8,commuter,104,110,104,"{104: 111.94215539345466, 105: 107.947260852268, 106: 95.96257722870806, 107: 75.98810452277479, 108: 48.023842734468246, 109: 12.069791863788396}"
214,7,19,25.66275827259585,2,5,24,0.1751341107392485,"[6, 9, 11]",128.52158751252233,3.0508539263719805,19,commuter,187,192,187,"{187: 128.52158751252233, 188: 125.47073358615035, 189: 116.3181718070344, 190: 101.0639021751745, 191: 79.70792469057065}"
214,6,15,28.752599896712162,2,5,20,0.08270221896020068,"[13, 2, 4]",107.72022361259575,3.1787523737359065,15,commuter,159,164,159,"{159: 107.72022361259575, 160: 104.54147123885984, 161: 95.00521411765212, 162: 79.11145224897258, 163: 56.86018563282124}"
214,0,18,22.324080449140354,3,6,24,0.1751341107392485,"[11, 9, 5]",116.70015326808647,1.3191881862378296,18,commuter,18,24,18,"{18: 116.70015326808647, 19: 115.38096508184864, 20: 111.42340052313514, 21: 104.827459591946, 22: 95.5931422882812, 23: 83.72044861214073}"
214,13,18,38.974896434068384,5,7,24,0.1488639941283612,"[5, 8, 7]",69.55483983561021,3.9200439550983113,18,commuter,330,337,330,"{330: 69.55483983561021, 331: 65.6347958805119, 332: 53.874664015216965, 333: 34.27444423972541, 334: 6.834136554037229, 335: 0}"
215,11,8,43.67969448941638,3,6,14,0.3609757344090773,"[4, 3, 8]",81.41674127919636,2.496851182956232,8,commuter,272,278,272,"{272: 81.41674127919636, 273: 78.91989009624012, 274: 71.42933654737143, 275: 58.945080632590276, 276: 41.46712235189665, 277: 18.99546170529056}"
215,9,7,62.284514059008444,8,9,16,0.3609757344090773,"[4, 6, 3]",68.34094636173508,4.1115605695687005,7,commuter,223,232,223,"{223: 68.34094636173508, 224: 64.22938579216638, 225: 51.894704083460276, 226: 31.33690123561677, 227: 2.5559772486358696, 228: 0, 229: 0, 230: 0, 231: 0}"
215,9,19,50.30539805786678,4,7,24,0.4331708812908929,"[13, 12, 2]",102.43754866553567,4.369888514373432,19,commuter,235,242,235,"{235: 102.43754866553567, 236: 98.06766015116224, 237: 84.95799460804194, 238: 63.108552036174785, 239: 32.519332435560756, 240: 0, 241: 0}"
215,11,7,43.46285018903387,3,6,13,0.3609757344090773,"[11, 7, 2]",74.27982645276724,4.890358147006229,7,commuter,271,277,271,"{271: 74.27982645276724, 272: 69.38946830576101, 273: 54.718393864742325, 274: 30.26660312971117, 275: 0, 276: 0}"
215,12,12,31.102439929640276,3,5,17,0.20455291616514384,"[13, 2, 8]",130.356760140031,1.8618131078225733,12,commuter,300,305,300,"{300: 130.356760140031, 301: 128.49494703220844, 302: 122.90950770874072, 303: 113.60044216962785, 304: 100.56775041486983}"
216,12,20,42.15998607033141,4,11,24,0.12298937366142625,"[14, 10, 11]",104.92200998868637,2.5377149322695316,20,night_charger,308,319,308,"{308: 104.92200998868637, 309: 102.38429505641683, 310: 94.77115025960825, 311: 82.08257559826059, 312: 64.31857107237386, 313: 41.47913668194808, 314: 13.564272426983237, 315: 0, 316: 0, 317: 0, 318: 0}"
216,13,21,53.45928096895898,3,11,24,0.06832742981190348,"[14, 7, 6]",120.35850589987712,1.7149249463809082,21,night_charger,333,344,333,"{333: 120.35850589987712, 334: 118.64358095349621, 335: 113.49880611435348}"
216,1,22,42.148649148744326,5,11,24,0.08038521154341585,"[14, 9, 0]",146.9235997267109,3.823448243585025,22,night_charger,46,57,46,"{46: 146.9235997267109, 47: 143.10015148312587, 48: 131.6298067523708, 49: 112.51256553444568, 50: 85.7484278293505, 51: 51.337393637085285, 52: 9.279462957649997, 53: 0, 54: 0, 55: 0, 56: 0}"
217,12,16,22.43898057232921,3,6,22,0.10654745791992842,"[2, 6, 8]",108.46601031717614,1.2666622051032932,16,commuter,304,310,304,"{304: 108.46601031717614, 305: 107.19934811207285, 306: 103.39936149676296, 307: 97.0660504712465, 308: 88.19941503552346, 309: 76.79945518959381}"
217,3,8,39.7968563368148,5,7,15,0.18802492574105015,"[14, 9, 13]",125.70320544610331,3.073323148039326,8,commuter,80,87,80,"{80: 125.70320544610331, 81: 122.62988229806399, 82: 113.40991285394601, 83: 98.04329711374938, 84: 76.5300350774741, 85: 48.87012674512016, 86: 15.063572116687581}"
217,8,7,62.99989214350448,5,8,15,0.18802492574105015,"[13, 4, 9]",70.4008636510767,1.4827538713849617,7,commuter,199,207,199,"{199: 70.4008636510767, 200: 68.91810977969175, 201: 64.46984816553686, 202: 57.05607880861205, 203: 46.67680170891732, 204: 33.33201686645266, 205: 17.021724281218084, 206: 0}"
217,7,18,55.77286323013713,3,5,23,0.2256299108892602,"[11, 3, 10]",117.22525000742135,1.148924807009167,18,commuter,186,191,186,"{186: 117.22525000742135, 187: 116.07632520041219, 188: 112.62955077938469, 189: 106.88492674433886, 190: 98.84245309527468}"
218,2,16,37.83658920954551,6,10,24,0.21237865643109105,"[12, 11, 10]",117.86270049882519,4.225581173339933,16,random,64,74,64,"{64: 117.86270049882519, 65: 113.63711932548526, 66: 100.96037580546546, 67: 79.8324699387658, 68: 50.25340172538627, 69: 12.223171165326875, 70: 0, 71: 0, 72: 0, 73: 0}"
218,7,14,26.84154940904145,2,3,17,0.21237865643109105,"[7, 11, 12]",92.13570877456067,4.569730153308656,14,random,182,185,182,"{182: 92.13570877456067, 183: 87.56597862125201, 184: 73.85678816132605}"
219,0,7,16.762993775869862,1,3,10,0.22250272955978875,"[2, 6, 13]",148.05338712886402,2.5711994284019304,7,random,7,10,7,"{7: 148.05338712886402, 8: 145.48218770046208, 9: 137.7685894152563}"
219,0,14,26.9918559825326,3,6,20,0.14833515303985917,"[1, 4, 9]",130.71637664216806,3.2435745752156424,14,random,14,20,14,"{14: 130.71637664216806, 15: 127.47280206695241, 16: 117.74207834130549, 17: 101.52420546522728, 18: 78.81918343871777, 19: 49.627012261777}"
219,2,10,43.73901350601264,3,4,14,0.14833515303985917,"[7, 4, 9]",131.24559504031123,3.9751237205794245,10,random,58,62,58,"{58: 131.24559504031123, 59: 127.27047131973181, 60: 115.34510015799353, 61: 95.46948155509641}"
220,12,13,38.41119025107229,2,7,20,0.17062859277363315,"[2, 8, 0]",133.00653721957792,3.8164894169297385,13,weekend_user,301,308,301,"{301: 133.00653721957792, 302: 129.1900478026482, 303: 117.74057955185897, 304: 98.65813246721027, 305: 71.9427065487021, 306: 37.59430179633446, 307: 0}"
221,7,9,16.249359844401745,1,2,11,0.2976691051143285,"[13, 5, 3]",94.90879571685771,2.4233215146706435,9,commuter,177,179,177,"{177: 94.90879571685771, 178: 92.48547420218706}"
221,8,7,23.241044746605734,2,5,12,0.2976691051143285,"[8, 0, 13]",53.9196835455743,3.0608711850851713,7,commuter,199,204,199,"{199: 53.9196835455743, 200: 50.85881236048913, 201: 41.67619880523362, 202: 26.371842879807758, 203: 4.94574458421156}"
221,9,18,26.908659843569517,2,3,21,0.35720292613719423,"[14, 12, 10]",66.28582916378278,3.937293632874099,18,commuter,234,237,234,"{234: 66.28582916378278, 235: 62.34853553090868, 236: 50.536654632286385}"
221,0,18,22.519031440646977,2,5,23,0.35720292613719423,"[6, 3, 0]",66.67455686259366,2.8131385853506328,18,commuter,18,23,18,"{18: 66.67455686259366, 19: 63.861418277243025, 20: 55.42200252119113, 21: 41.35630959443797, 22: 21.664339496983537}"
221,13,19,23.75180950434105,3,4,23,0.30362248721661506,"[9, 2, 14]",94.32811764267336,4.791843667005579,19,commuter,331,335,331,"{331: 94.32811764267336, 332: 89.53627397566778, 333: 75.16074297465104, 334: 51.20152463962315}"
222,8,7,61.71345953542384,8,9,16,0.11705566116861128,"[10, 8, 5]",135.44926133956693,2.9223130107547135,7,random,199,208,199,"{199: 135.44926133956693, 200: 132.5269483288122, 201: 123.76000929654808, 202: 109.1484442427745, 203: 88.69225316749151, 204: 62.391436070699086, 205: 30.245992952397245, 206: 0, 207: 0}"
222,5,20,52.95813317221108,7,8,24,0.11939677439198351,"[9, 11, 8]",132.7276954871939,3.7416264921612843,20,random,140,148,140,"{140: 132.7276954871939, 141: 128.9860689950326, 142: 117.76118951854876, 143: 99.05305705774234, 144: 72.86167161261335, 145: 39.18703318316179, 146: 0, 147: 0}"
223,11,22,30.769604129589222,3,11,24,0.12843904441968548,"[2, 8, 9]",53.992765880517126,4.303421683437808,22,night_charger,286,297,286,"{286: 53.992765880517126, 287: 49.68934419707932, 288: 36.779079146765895, 289: 15.26197072957686, 290: 0, 291: 0, 292: 0, 293: 0, 294: 0, 295: 0, 296: 0}"
223,6,21,51.08842895870312,5,12,24,0.10917318775673267,"[12, 6, 14]",135.07306845860373,2.1784731987396135,21,night_charger,165,177,165,"{165: 135.07306845860373, 166: 132.8945952598641, 167: 126.35917566364527, 168: 115.46680966994721, 169: 100.21749727876991, 170: 80.6112384901134, 171: 56.64803330397764, 172: 28.32788172036267, 173: 0, 174: 0, 175: 0, 176: 0}"
223,11,20,21.280482437624798,2,7,24,0.2311902799554339,"[4, 13, 2]",53.23685340055202,1.3535129838436157,20,night_charger,284,291,284,"{284: 53.23685340055202, 285: 51.88334041670841, 286: 47.82280146517756, 287: 41.05523654595948, 288: 31.58064565905417, 289: 19.39902880446163, 290: 4.510385982181859}"
224,6,13,31.9929926660475,4,7,20,0.07574842132195489,"[8, 9, 5]",50.58969400367867,1.1401266117624673,13,commuter,157,164,157,"{157: 50.58969400367867, 158: 49.449567391916204, 159: 46.029187556628806, 160: 40.32855449781647, 161: 32.347668215479196, 162: 22.08652870961699, 163: 9.545135980229851}"
224,3,9,38.6256311827459,3,5,14,0.13367368468580273,"[12, 9, 2]",79.14806725790984,4.875369628393566,9,commuter,81,86,81,"{81: 79.14806725790984, 82: 74.27269762951627, 83: 59.64658874433558, 84: 35.269740602367754, 85: 1.1421532036127928}"
224,5,13,61.67290714117318,4,7,20,0.07574842132195489,"[11, 4, 8]",52.17889497622556,4.157292041444654,13,commuter,133,140,133,"{133: 52.17889497622556, 134: 48.0216029347809, 135: 35.54972681044694, 136: 14.76326660322367, 137: 0, 138: 0, 139: 0}"
224,7,8,56.60319509647509,5,7,15,0.13367368468580273,"[12, 4, 11]",52.174080783667485,1.9578192563420078,8,commuter,176,183,176,"{176: 52.174080783667485, 177: 50.21626152732548, 178: 44.34280375829945, 179: 34.553707476589416, 180: 20.84897268219536, 181: 3.228599375117291, 182: 0}"
225,6,19,72.39219125536741,4,7,24,0.15725550788767217,"[8, 4, 11]",58.47806237297544,3.293294852412093,19,weekend_user,163,170,163,"{163: 58.47806237297544, 164: 55.18476752056334, 165: 45.30488296332707, 166: 28.8384087012666, 167: 5.785344734381951, 168: 0, 169: 0}"
226,0,19,60.12077737055286,7,12,24,0.17826023436225394,"[3, 0, 6]",58.453261529357235,2.877577514125316,19,night_charger,19,31,19,"{19: 58.453261529357235, 20: 55.57568401523192, 21: 46.94295147285597, 22: 32.55506390222939, 23: 12.412021303352176, 24: 0, 25: 0, 26: 0, 27: 0, 28: 0, 29: 0, 30: 0}"
226,8,20,25.63291591731899,2,8,24,0.17826023436225394,"[0, 8, 5]",52.40376966664088,4.697715008629892,20,night_charger,212,220,212,"{212: 52.40376966664088, 213: 47.70605465801099, 214: 33.612909632121315, 215: 10.124334588971855, 216: 0, 217: 0, 218: 0, 219: 0}"
227,11,21,61.923475429357076,4,12,24,0.2150413826966786,"[2, 5, 11]",141.61871480738876,2.83085620599293,21,night_charger,285,297,285,"{285: 141.61871480738876, 286: 138.78785860139584, 287: 130.29528998341704, 288: 116.14100895345238, 289: 96.32501551150187, 290: 70.8473096575655, 291: 39.70789139164327, 292: 2.9067607137351956, 293: 0, 294: 0, 295: 0, 296: 0}"
227,8,20,61.63163069581054,8,12,24,0.3870744888540215,"[10, 9, 0]",102.53712797848466,4.286840914502136,20,night_charger,212,224,212,"{212: 102.53712797848466, 213: 98.25028706398253, 214: 85.38976432047612, 215: 63.95555974796544, 216: 33.947673346450486, 217: 0, 218: 0, 219: 0, 220: 0, 221: 0, 222: 0, 223: 0}"
228,2,12,39.90110150099091,4,7,19,0.17620593309654053,"[12, 7, 10]",99.99143878668599,3.5250890265646366,12,work_charger,60,67,60,"{60: 99.99143878668599, 61: 96.46634976012135, 62: 85.89108268042744, 63: 68.26563754760426, 64: 43.590014361651804, 65: 11.864213122570078, 66: 0}"
228,11,8,38.82901963852306,6,8,16,0.2643088996448108,"[10, 6, 2]",125.30576099149094,3.9061047744396915,8,work_charger,272,280,272,"{272: 125.30576099149094, 273: 121.39965621705124, 274: 109.68134189373218, 275: 90.15081802153372, 276: 62.80808460045588, 277: 27.653141630498652, 278: 0, 279: 0}"
228,2,11,47.87456249143676,3,7,18,0.17620593309654053,"[8, 6, 9]",122.08252280828007,2.0038912619194176,11,work_charger,59,66,59,"{59: 122.08252280828007, 60: 120.07863154636065, 61: 114.0669577606024, 62: 104.04750145100532, 63: 90.02026261756939, 64: 71.98524126029463, 65: 49.942437379181044}"
229,12,11,68.90105134678012,8,12,23,0.0758871880658334,"[8, 3, 12]",98.4368151342658,3.2954510958506007,11,weekend_user,299,311,299,"{299: 98.4368151342658, 300: 95.1413640384152, 301: 85.25501075086339, 302: 68.77775527161039, 303: 45.70959760065619, 304: 16.050537738000784, 305: 0, 306: 0, 307: 0, 308: 0, 309: 0, 310: 0}"
229,12,19,72.23231172414994,4,7,24,0.1365969385185001,"[4, 10, 14]",145.21238781308705,3.253058882082482,19,weekend_user,307,314,307,"{307: 145.21238781308705, 308: 141.95932893100456, 309: 132.2001522847571, 310: 115.93485787434471, 311: 93.16344569976734, 312: 63.885915761025004, 313: 28.1022680581177}"
230,5,13,10.668564999793972,1,6,19,0.06517907368674235,"[13, 2, 7]",143.18832818364257,1.5808467468586822,13,weekend_user,133,139,133,"{133: 143.18832818364257, 134: 141.6074814367839, 135: 136.86494119620784, 136: 128.96070746191444, 137: 117.89478023390365, 138: 103.66715951217552}"
231,4,21,21.842516566984422,3,9,24,0.16778270804332943,"[8, 4, 5]",121.48429288450242,2.4660688142184815,21,night_charger,117,126,117,"{117: 121.48429288450242, 118: 119.01822407028394, 119: 111.6200176276285, 120: 99.28967355653609, 121: 82.02719185700673, 122: 59.832572529040384, 123: 32.70581557263709, 124: 0.6469209877968325, 125: 0}"
231,12,21,15.62849650854582,1,8,24,0.14261530183683002,"[3, 1, 6]",53.95709618113538,4.859992233371547,21,night_charger,309,317,309,"{309: 53.95709618113538, 310: 49.09710394776383, 311: 34.517127247649185, 312: 10.21716608079145, 313: 0, 314: 0, 315: 0, 316: 0}"
232,8,20,51.91141787686372,5,10,24,0.297568814143695,"[6, 8, 0]",68.80487531469086,1.0162423451475027,20,night_charger,212,222,212,"{212: 68.80487531469086, 213: 67.78863296954336, 214: 64.73990593410085, 215: 59.658694208363336, 216: 52.54499779233082, 217: 43.39881668600329, 218: 32.22015088938076, 219: 19.00900040246323, 220: 3.76536522525069, 221: 0}"
232,12,20,28.01892258410512,3,8,24,0.2529334920221407,"[10, 7, 8]",69.70350864679634,3.720985962794094,20,night_charger,308,316,308,"{308: 69.70350864679634, 309: 65.98252268400225, 310: 54.81956479561996, 311: 36.21463498164949, 312: 10.167733242090833, 313: 0, 314: 0, 315: 0}"
232,6,22,40.88071942546063,2,7,24,0.14051860667896707,"[7, 8, 2]",55.26731562054509,2.1716430621522904,22,night_charger,166,173,166,"{166: 55.26731562054509, 167: 53.0956725583928, 168: 46.58074337193593, 169: 35.72252806117447, 170: 20.521026626108444, 171: 0.9762390667378327, 172: 0}"
233,9,17,31.713350530343853,4,6,23,0.2232612231349209,"[0, 13, 4]",66.28722281643479,3.189171057387927,17,commuter,233,239,233,"{233: 66.28722281643479, 234: 63.09805175904687, 235: 53.53053858688308, 236: 37.58468329994345, 237: 15.260485898227962, 238: 0}"
233,11,9,85.75726836187454,5,7,16,0.1860510192791007,"[2, 6, 0]",125.15530563490262,1.9536948019814222,9,commuter,273,280,273,"{273: 125.15530563490262, 274: 123.20161083292119, 275: 117.34052642697694, 276: 107.57205241706981, 277: 93.89618880319986, 278: 76.31293558536706, 279: 54.822292763571426}"
233,1,19,29.079100652220973,3,6,24,0.2232612231349209,"[6, 0, 8]",142.32258784862324,3.385519330809463,19,commuter,43,49,43,"{43: 142.32258784862324, 44: 138.93706851781377, 45: 128.78051052538538, 46: 111.85291387133807, 47: 88.15427855567184, 48: 57.68460457838667}"
234,4,9,55.37300179998759,3,6,15,0.11388020131895554,"[7, 8, 9]",126.12115151654739,4.083090752842429,9,commuter,105,111,105,"{105: 126.12115151654739, 106: 122.03806076370496, 107: 109.78878850517768, 108: 89.37333474096553, 109: 60.791699471068526, 110: 24.043882695486673}"
234,2,19,62.92352177656194,5,8,24,0.13665624158274667,"[6, 5, 2]",65.46075367370416,1.8261918790755836,19,commuter,67,75,67,"{67: 65.46075367370416, 68: 63.63456179462858, 69: 58.15598615740183, 70: 49.02502676202391, 71: 36.241683608494824, 72: 19.805956696814576, 73: 0, 74: 0}"
234,6,19,37.60367691558926,3,6,24,0.11615780534533465,"[12, 2, 5]",59.666476716567104,2.3406125704892826,19,commuter,163,169,163,"{163: 59.666476716567104, 164: 57.32586414607782, 165: 50.30402643460997, 166: 38.60096358216356, 167: 22.216675588738582, 168: 1.1511624543350365}"
234,5,11,68.29839883011616,4,5,16,0.06453211408074148,"[0, 14, 11]",125.11537036455785,4.041549528722014,11,commuter,131,136,131,"{131: 125.11537036455785, 132: 121.07382083583583, 133: 108.9491722496698, 134: 88.74142460605972, 135: 60.45057790500563}"
235,10,8,30.695016289187073,3,7,15,0.24904851878435078,"[1, 8, 12]",108.6558560747354,2.489081032506709,8,random,248,255,248,"{248: 108.6558560747354, 249: 106.16677504222869, 250: 98.69953194470855, 251: 86.254126782175, 252: 68.83055955462805, 253: 46.42883026206767, 254: 19.048938904493866}"
235,13,17,10.798087160834855,2,5,22,0.2540294891600378,"[1, 2, 5]",86.03984051195147,2.566992350420847,17,random,329,334,329,"{329: 86.03984051195147, 330: 83.47284816153062, 331: 75.77187111026808, 332: 62.936909358163845, 333: 44.96796290521792}"
236,3,18,19.093713109736782,2,4,22,0.24314294908739223,"[5, 10, 4]",96.6606265926182,1.8001969325854996,18,commuter,90,94,90,"{90: 96.6606265926182, 91: 94.86042966003271, 92: 89.4598388622762, 93: 80.4588541993487}"
236,3,17,40.980081015921954,6,8,24,0.24314294908739223,"[10, 12, 7]",104.73777534997463,1.2482805468340445,17,commuter,89,97,89,"{89: 104.73777534997463, 90: 103.48949480314059, 91: 99.74465316263844, 92: 93.50325042846822, 93: 84.7652866006299, 94: 73.53076167912351, 95: 59.799675663949024, 96: 43.57202855510644}"
236,11,17,43.12293078879271,4,5,22,0.24314294908739223,"[10, 12, 8]",100.94018695309703,3.9012423021628018,17,commuter,281,286,281,"{281: 100.94018695309703, 282: 97.03894465093423, 283: 85.33521774444581, 284: 65.82900623363182, 285: 38.5203101184922}"
236,8,8,30.626755446963678,2,3,11,0.2026191242394935,"[6, 0, 10]",52.9771907407132,3.016593958913265,8,commuter,200,203,200,"{200: 52.9771907407132, 201: 49.960596781799936, 202: 40.910814905060136}"
236,7,9,43.876600107718545,4,6,15,0.2026191242394935,"[3, 6, 11]",71.74229711342132,2.05626854269466,9,commuter,177,183,177,"{177: 71.74229711342132, 178: 69.68602857072665, 179: 63.517222942642675, 180: 53.235880229169375, 181: 38.842000430306754, 182: 20.335583546054814}"
237,4,7,44.14797408467368,5,6,13,0.12246763976548208,"[0, 11, 9]",129.23509643549306,2.026794185858261,7,random,103,109,103,"{103: 129.23509643549306, 104: 127.2083022496348, 105: 121.12791969206002, 106: 110.99394876276871, 107: 96.80638946176089, 108: 78.56524178903653}"
237,11,11,43.40295680791032,3,4,15,0.08164509317698805,"[7, 9, 1]",104.0709954916197,2.801117931458163,11,random,275,279,275,"{275: 104.0709954916197, 276: 101.26987756016153, 277: 92.86652376578705, 278: 78.86093410849622}"
238,0,18,54.54423827370111,3,6,24,0.5353090345427723,"[9, 8, 2]",141.80765622686414,1.764732156389265,18,commuter,18,24,18,"{18: 141.80765622686414, 19: 140.04292407047487, 20: 134.74872760130708, 21: 125.92506681936075, 22: 113.5719417246359, 23: 97.68935231713252}"
238,10,17,23.145929696359243,2,5,22,0.5353090345427723,"[0, 10, 3]",131.51832322927527,2.436690602237201,17,commuter,257,262,257,"{257: 131.51832322927527, 258: 129.08163262703806, 259: 121.77156082032647, 260: 109.58810780914047, 261: 92.53127359348005}"
238,12,15,42.3313364820131,4,7,22,0.25278482186742024,"[11, 2, 7]",85.02019253129683,4.087624973600357,15,commuter,303,310,303,"{303: 85.02019253129683, 304: 80.93256755769647, 305: 68.6696926368954, 306: 48.23156776889362, 307: 19.61819295369112, 308: 0, 309: 0}"
238,3,19,22.9046323989717,2,4,23,0.5353090345427723,"[13, 11, 5]",148.18080227178268,2.5183745752897595,19,commuter,91,95,91,"{91: 148.18080227178268, 92: 145.66242769649293, 93: 138.10730397062363, 94: 125.51543109417484}"
238,2,17,46.64400054389935,3,6,23,0.5353090345427723,"[10, 7, 0]",64.42974022752794,4.532230916930269,17,commuter,65,71,65,"{65: 64.42974022752794, 66: 59.89750931059768, 67: 46.30081655980687, 68: 23.639661975155526, 69: 0, 70: 0}"
239,11,19,70.24714844983932,8,11,24,0.4824452922039523,"[8, 5, 10]",142.1878793369349,1.7147718091452533,19,commuter,283,294,283,"{283: 142.1878793369349, 284: 140.47310752778967, 285: 135.3287921003539, 286: 126.75493305462763, 287: 114.75153039061087, 288: 99.31858410830358, 289: 80.4560942077058, 290: 58.1640606888175, 291: 32.4424835516387, 292: 3.291362796169409, 293: 0}"
239,1,17,15.46250434204618,3,5,22,0.4824452922039523,"[1, 11, 10]",104.68365102699866,2.115402120347059,17,commuter,41,46,41,"{41: 104.68365102699866, 42: 102.5682489066516, 43: 96.22204254561042, 44: 85.64503194387513, 45: 70.83721710144572}"
239,9,8,65.45153174511543,4,6,14,0.4020377435032935,"[14, 7, 9]",132.38773636258043,2.9181457801721056,8,commuter,224,230,224,"{224: 132.38773636258043, 225: 129.46959058240833, 226: 120.71515324189201, 227: 106.12442434103147, 228: 85.69740387982674, 229: 59.43409185827778}"
239,6,17,41.4301535534061,4,7,24,0.4100784983733594,"[4, 6, 14]",65.67043477959481,3.1632482831923023,17,commuter,161,168,161,"{161: 65.67043477959481, 162: 62.50718649640251, 163: 53.0174416468256, 164: 37.20120023086409, 165: 15.058462248517976, 166: 0, 167: 0}"
240,9,9,54.22690249286558,5,7,16,0.16001621320038073,"[0, 7, 9]",92.18583923674969,1.0765054024949214,9,work_charger,225,232,225,"{225: 92.18583923674969, 226: 91.10933383425477, 227: 87.87981762677, 228: 82.4972906142954, 229: 74.96175279683095, 230: 65.27320417437664, 231: 53.43164474693251}"
240,2,13,89.50793175572223,8,10,23,0.10667747546692048,"[1, 5, 13]",102.18519444952847,1.5426004237488322,13,work_charger,61,71,61,"{61: 102.18519444952847, 62: 100.64259402577963, 63: 96.01479275453313, 64: 88.30179063578898, 65: 77.50358766954716, 66: 63.62018385580766, 67: 46.65157919457051, 68: 26.59777368583569, 69: 3.458767329603205, 70: 0}"
240,11,10,68.11225730032834,6,9,19,0.10667747546692048,"[9, 13, 10]",64.86843923566967,4.471329986937986,10,work_charger,274,283,274,"{274: 64.86843923566967, 275: 60.39710924873168, 276: 46.983119287917724, 277: 24.62646935322779, 278: 0, 279: 0, 280: 0, 281: 0, 282: 0}"
240,2,9,23.546612655271787,2,5,14,0.16001621320038073,"[12, 1, 6]",58.57100934382839,1.5572234666910316,9,work_charger,57,62,57,"{57: 58.57100934382839, 58: 57.01378587713736, 59: 52.34211547706427, 60: 44.55599814360911, 61: 33.65543387677189}"
241,13,12,43.38515886881087,4,8,20,0.06850896692415627,"[9, 6, 12]",138.0378725186174,4.398962912581501,12,weekend_user,324,332,324,"{324: 138.0378725186174, 325: 133.6389096060359, 326: 120.4420208682914, 327: 98.4472063053839, 328: 67.65446591731339, 329: 28.063799704079884, 330: 0, 331: 0}"
241,13,17,17.630727867702568,2,6,23,0.12331614046348127,"[8, 7, 6]",58.91704771863835,1.4086529356248878,17,weekend_user,329,335,329,"{329: 58.91704771863835, 330: 57.508394783013465, 331: 53.2824359761388, 332: 46.23917129801436, 333: 36.378600748640146, 334: 23.700724328016157}"
242,4,7,47.331030777089296,4,6,13,0.26215068708349604,"[8, 5, 12]",68.51759388450591,3.219368761486432,7,commuter,103,109,103,"{103: 68.51759388450591, 104: 65.29822512301948, 105: 55.640118838560184, 106: 39.543275031128026, 107: 17.007693700723003, 108: 0}"
242,0,9,38.80378905753541,2,4,13,0.26215068708349604,"[11, 10, 3]",113.39032270481124,3.5730959752411837,9,commuter,9,13,9,"{9: 113.39032270481124, 10: 109.81722672957005, 11: 99.0979388038465, 12: 81.23245892764058}"
242,3,7,41.70633449031636,3,5,12,0.26215068708349604,"[14, 5, 10]",129.25911401965442,2.9764016630337577,7,commuter,79,84,79,"{79: 129.25911401965442, 80: 126.28271235662066, 81: 117.35350736751938, 82: 102.4714990523506, 83: 81.6366874111143}"
243,10,11,10.233029033052759,1,5,16,0.12453686173077635,"[3, 7, 11]",142.12864116801074,2.006717615441241,11,random,251,256,251,"{251: 142.12864116801074, 252: 140.1219235525695, 253: 134.1017707062458, 254: 124.06818262903957, 255: 110.02115932095089}"
244,4,9,33.86701650213175,3,8,17,0.19137568414072748,"[9, 8, 1]",122.95038264293837,3.4081981741974032,9,work_charger,105,113,105,"{105: 122.95038264293837, 106: 119.54218446874096, 107: 109.31758994614876, 108: 92.27659907516174, 109: 68.4192118557799, 110: 37.74542828800328, 111: 0.2552483718318541, 112: 0}"
244,11,8,45.79669357020414,3,5,13,0.19137568414072748,"[11, 14, 8]",60.88816160311657,2.8365196311017455,8,work_charger,272,277,272,"{272: 60.88816160311657, 273: 58.05164197201483, 274: 49.54208307870959, 275: 35.35948492320087, 276: 15.503847505488643}"
244,11,9,33.5588599494815,3,7,16,0.19137568414072748,"[13, 11, 8]",136.7792454751724,1.6531667279902362,9,work_charger,273,280,273,"{273: 136.7792454751724, 274: 135.12607874718216, 275: 130.16657856321143, 276: 121.90074492326026, 277: 110.32857782732862, 278: 95.45007727541648, 279: 77.26524326752389}"
244,6,18,29.570085338801967,2,4,22,0.195203197823542,"[4, 13, 8]",109.49302374008252,4.3624024900165805,18,work_charger,162,166,162,"{162: 109.49302374008252, 163: 105.13062125006594, 164: 92.0434137800162, 165: 70.2314013299333}"
245,3,18,43.08563384620696,3,4,22,0.2232406738945201,"[1, 11, 3]",123.7817727586946,2.82000647411189,18,commuter,90,94,90,"{90: 123.7817727586946, 91: 120.96176628458271, 92: 112.50174686224705, 93: 98.40171449168758}"
245,11,9,76.72571829260406,8,11,20,0.18603389491210004,"[11, 5, 9]",86.94787236337332,2.6929577659607458,9,commuter,273,284,273,"{273: 86.94787236337332, 274: 84.25491459741258, 275: 76.17604129953034, 276: 62.71125246972661, 277: 43.86054810800139, 278: 19.623928214354677, 279: 0, 280: 0, 281: 0, 282: 0, 283: 0}"
245,13,19,78.28472562428743,8,10,24,0.18975457281034205,"[14, 6, 5]",114.49637707451961,3.222539028819879,19,commuter,331,341,331,"{331: 114.49637707451961, 332: 111.27383804569973, 333: 101.60622095924009, 334: 85.4935258151407, 335: 62.93575261340155}"
245,3,17,63.64288062365362,4,6,23,0.2232406738945201,"[9, 5, 7]",63.021412832870595,2.8087524180503456,17,commuter,89,95,89,"{89: 63.021412832870595, 90: 60.21266041482025, 91: 51.78640316066921, 92: 37.742641070417484, 93: 18.081374144065066, 94: 0}"
246,9,9,57.9453422866454,6,10,19,0.1569278910451632,"[2, 4, 6]",64.36764363547702,1.1838491880444413,9,work_charger,225,235,225,"{225: 64.36764363547702, 226: 63.18379444743258, 227: 59.63224688329926, 228: 53.71300094307705, 229: 45.42605662676596, 230: 34.771413934365995, 231: 21.74907286587714, 232: 6.359033421299401, 233: 0, 234: 0}"
246,11,11,39.5913732741967,6,9,20,0.1046185940301088,"[14, 5, 3]",106.78905483054052,4.340504653372816,11,work_charger,275,284,275,"{275: 106.78905483054052, 276: 102.4485501771677, 277: 89.42703621704925, 278: 67.72451295018517, 279: 37.34098037657546, 280: 0, 281: 0, 282: 0, 283: 0}"
246,0,9,33.442173813960956,4,8,17,0.1569278910451632,"[7, 14, 9]",62.71192918570485,3.02468034262081,9,work_charger,9,17,9,"{9: 62.71192918570485, 10: 59.687248843084035, 11: 50.61320781522161, 12: 35.489806102117555, 13: 14.317043703771887, 14: 0, 15: 0, 16: 0}"
246,8,10,38.74665639985741,3,8,18,0.1046185940301088,"[10, 8, 11]",114.82760244270396,4.508187698430998,10,work_charger,202,210,202,"{202: 114.82760244270396, 203: 110.31941474427296, 204: 96.79485164897997, 205: 74.25391315682498, 206: 42.696599267808, 207: 2.1229099819290127, 208: 0, 209: 0}"
247,13,12,54.37895631832392,3,4,16,0.1058428890439992,"[11, 2, 9]",146.91165309407387,1.627077749340009,12,commuter,324,328,324,"{324: 146.91165309407387, 325: 145.28457534473387, 326: 140.40334209671383, 327: 132.26795335001378}"
247,6,10,27.975595523038653,2,3,13,0.1058428890439992,"[4, 13, 6]",56.30153906928105,3.4023868143178,10,commuter,154,157,154,"{154: 56.30153906928105, 155: 52.89915225496325, 156: 42.691991812009846}"
247,6,15,66.15049527517627,4,6,21,0.1058428890439992,"[2, 5, 11]",91.73414732663258,4.889461939119913,15,commuter,159,165,159,"{159: 91.73414732663258, 160: 86.84468538751267, 161: 72.17629957015293, 162: 47.72898987455336, 163: 13.502756300713969, 164: 0}"
248,13,14,38.63589450497983,2,4,18,0.10886249931517028,"[3, 14, 4]",133.81920347835842,2.881295302183918,14,commuter,326,330,326,"{326: 133.81920347835842, 327: 130.9379081761745, 328: 122.29402226962274, 329: 107.88754575870315}"
248,3,9,24.586707144845917,3,4,13,0.192110292909124,"[12, 6, 2]",84.02882064196245,3.056941931412212,9,commuter,81,85,81,"{81: 84.02882064196245, 82: 80.97187871055024, 83: 71.80105291631361, 84: 56.51634325925255}"
248,5,17,32.93349522607432,2,5,22,0.19595249876730647,"[9, 7, 3]",97.96137541640834,3.6323702437586713,17,commuter,137,142,137,"{137: 97.96137541640834, 138: 94.32900517264967, 139: 83.43189444137366, 140: 65.27004322258031, 141: 39.8434515162696}"
248,6,15,33.09286385271484,2,4,19,0.10886249931517028,"[12, 11, 3]",55.235445018579874,4.613587202013527,15,commuter,159,163,159,"{159: 55.235445018579874, 160: 50.62185781656635, 161: 36.78109621052577, 162: 13.713160200458134}"
248,5,16,43.73850630224914,3,4,20,0.10886249931517028,"[2, 6, 11]",79.39165968905657,3.2988128156779513,16,commuter,136,140,136,"{136: 79.39165968905657, 137: 76.09284687337862, 138: 66.19640842634476, 139: 49.702344347955005}"
249,6,15,9.421328442579956,1,4,19,0.10524728884999285,"[2, 9, 12]",84.94744959581692,3.3812430073738007,15,weekend_user,159,163,159,"{159: 84.94744959581692, 160: 81.56620658844312, 161: 71.42247756632172, 162: 54.51626252945272}"
249,13,11,50.943785904363985,4,10,21,0.10524728884999285,"[12, 5, 10]",132.8744265728477,2.142634678331531,11,weekend_user,323,333,323,"{323: 132.8744265728477, 324: 130.7317918945162, 325: 124.30388785952158, 326: 113.59071446786393, 327: 98.59227171954322, 328: 79.30855961455944, 329: 55.739578152912586, 330: 27.885327334602692, 331: 0, 332: 0}"
250,3,7,31.826192071394935,3,4,11,0.16230239588817794,"[10, 1, 8]",92.90727674550033,1.0704660285644292,7,commuter,79,83,79,"{79: 92.90727674550033, 80: 91.8368107169359, 81: 88.62541263124261, 82: 83.27308248842047}"
250,4,8,50.26463517494366,5,6,14,0.16230239588817794,"[6, 12, 1]",147.10658321072984,1.5104092332605656,8,commuter,104,110,104,"{104: 147.10658321072984, 105: 145.59617397746928, 106: 141.06494627768757, 107: 133.51290011138474, 108: 122.94003547856079, 109: 109.34635237921569}"
250,2,19,50.37615395568389,5,7,24,0.19476287506581358,"[14, 2, 1]",145.7490531021221,2.8345139497258636,19,commuter,67,74,67,"{67: 145.7490531021221, 68: 142.91453915239623, 69: 134.41099730321866, 70: 120.23842755458934, 71: 100.39682990650829, 72: 74.88620435897552, 73: 43.706550911991016}"
250,13,19,42.10381826538961,5,7,24,0.1655484438059415,"[3, 13, 1]",56.43929464662364,2.076745760686749,19,commuter,331,338,331,"{331: 56.43929464662364, 332: 54.36254888593689, 333: 48.132311603876644, 334: 37.7485828004429, 335: 23.211362475635653}"
250,4,9,66.5963852466171,4,5,14,0.16230239588817794,"[11, 2, 9]",93.06735714824552,1.4587249695146807,9,commuter,105,110,105,"{105: 93.06735714824552, 106: 91.60863217873084, 107: 87.2324572701868, 108: 79.93883242261339, 109: 69.72775763601064}"
251,2,22,19.96131294622353,3,9,24,0.11489751774073184,"[5, 12, 6]",52.861014359923516,4.6795069107009635,22,night_charger,70,79,70,"{70: 52.861014359923516, 71: 48.18150744922255, 72: 34.14298671711966, 73: 10.745452163614843, 74: 0, 75: 0, 76: 0, 77: 0, 78: 0}"
251,10,19,37.75037284690604,3,9,24,0.20681553193331734,"[5, 9, 14]",135.90181543707683,1.030683197159155,19,night_charger,259,268,259,"{259: 135.90181543707683, 260: 134.87113223991767, 261: 131.7790826484402, 262: 126.62566666264443, 263: 119.41088428253036, 264: 110.13473550809796, 265: 98.79722033934726, 266: 85.39833877627824, 267: 69.93809081889091}"
252,11,11,22.456759927563013,2,4,15,0.08421270123848029,"[12, 11, 14]",111.35146827175126,2.8530264175780107,11,work_charger,275,279,275,"{275: 111.35146827175126, 276: 108.49844185417325, 277: 99.93936260143921, 278: 85.67423051354916}"
252,3,13,25.27678161332855,4,7,20,0.08421270123848029,"[13, 3, 5]",65.20597277780324,4.168863615219099,13,work_charger,85,92,85,"{85: 65.20597277780324, 86: 61.037109162584144, 87: 48.530518316926845, 88: 27.686200240831354, 89: 0, 90: 0, 91: 0}"
252,3,9,14.90972132895321,2,4,13,0.12631905185772044,"[9, 6, 10]",89.55779146961238,2.9064785526057935,9,work_charger,81,85,81,"{81: 89.55779146961238, 82: 86.65131291700659, 83: 77.9318772591892, 84: 63.39948449616024}"
253,5,15,44.210723285976826,5,7,22,0.22203055799884272,"[11, 7, 9]",68.92735001678754,3.134030650065947,15,commuter,135,142,135,"{135: 68.92735001678754, 136: 65.79331936672159, 137: 56.391227416523755, 138: 40.72107416619402, 139: 18.78285961573239, 140: 0, 141: 0}"
253,5,19,50.26074760727056,5,6,24,0.39965500439791685,"[6, 10, 14]",112.56693299249065,1.5936404935305486,19,commuter,139,145,139,"{139: 112.56693299249065, 140: 110.9732924989601, 141: 106.19237101836845, 142: 98.22416855071572, 143: 87.06868509600187, 144: 72.72592065422694}"
253,1,9,51.686417488818186,5,7,16,0.39181863176266357,"[9, 10, 13]",58.8180061240853,2.3474375287043476,9,commuter,33,40,33,"{33: 58.8180061240853, 34: 56.47056859538095, 35: 49.42825600926791, 36: 37.691068365746176, 37: 21.25900566481574, 38: 0.13206790647660682, 39: 0}"
253,12,15,69.24410125071006,4,6,21,0.22203055799884272,"[8, 7, 3]",51.85555390698604,3.4392466319148065,15,commuter,303,309,303,"{303: 51.85555390698604, 304: 48.41630727507123, 305: 38.09856737932681, 306: 20.90233421975278, 307: 0, 308: 0}"
254,4,22,38.92348777038523,3,11,24,0.08571548047986076,"[14, 3, 1]",135.19307491238942,4.099423189722826,22,night_charger,118,129,118,"{118: 135.19307491238942, 119: 131.0936517226666, 120: 118.79538215349811, 121: 98.29826620488399, 122: 69.60230387682421, 123: 32.707495169318776, 124: 0, 125: 0, 126: 0, 127: 0, 128: 0}"
254,2,21,28.12041056247778,3,8,24,0.08571548047986076,"[3, 1, 7]",135.36957139810394,4.019707346550779,21,night_charger,69,77,69,"{69: 135.36957139810394, 70: 131.34986405155317, 71: 119.29074201190083, 72: 99.19220527914693, 73: 71.05425385329148, 74: 34.876887734334474, 75: 0, 76: 0}"
255,12,18,44.34979009011912,6,12,24,0.1299630217209343,"[8, 5, 14]",137.9031971876471,3.5777219740584743,18,weekend_user,306,318,306,"{306: 137.9031971876471, 307: 134.32547521358862, 308: 123.5923092914132, 309: 105.70369942112083, 310: 80.6596456027115, 311: 48.46014783618524, 312: 9.105206121542011, 313: 0, 314: 0, 315: 0, 316: 0, 317: 0}"
255,12,18,53.37619957364056,4,8,24,0.1299630217209343,"[9, 12, 10]",149.10881551216158,1.539023645626738,18,weekend_user,306,314,306,"{306: 149.10881551216158, 307: 147.56979186653484, 308: 142.95272092965462, 309: 135.25760270152094, 310: 124.48443718213377, 311: 110.63322437149313, 312: 93.70396426959901, 313: 73.69665687645141}"
256,3,17,26.076851751877484,2,3,20,0.2911484302752774,"[4, 14, 1]",81.80311840864621,1.1246494128020132,17,commuter,89,92,89,"{89: 81.80311840864621, 90: 80.6784689958442, 91: 77.30452075743815}"
256,6,13,22.158254128763307,2,3,16,0.13748675874110322,"[7, 1, 4]",145.3322160466356,1.4429464980416813,13,commuter,157,160,157,"{157: 145.3322160466356, 158: 143.88926954859392, 159: 139.5604300544689}"
256,9,9,32.02339972616359,3,6,15,0.24262369189606448,"[1, 9, 11]",68.11120495167398,1.1799738544797687,9,commuter,225,231,225,"{225: 68.11120495167398, 226: 66.93123109719421, 227: 63.39130953375491, 228: 57.49144026135606, 229: 49.231623279997685, 230: 38.61185858967977}"
256,1,9,20.344445652435866,3,6,15,0.24262369189606448,"[1, 2, 0]",82.08242558583879,1.3591890642914413,9,commuter,33,39,33,"{33: 82.08242558583879, 34: 80.72323652154735, 35: 76.64566932867302, 36: 69.84972400721583, 37: 60.33540055717573, 38: 48.10269897855276}"
257,8,10,25.566700804766906,2,6,16,0.12559890450543323,"[13, 3, 2]",110.9711489241867,3.3795080377367337,10,work_charger,202,208,202,"{202: 110.9711489241867, 203: 107.59164088644998, 204: 97.45311677323977, 205: 80.5555765845561, 206: 56.89902032039897, 207: 26.48344798076836}"
257,7,12,22.234799309591516,4,8,20,0.12559890450543323,"[10, 12, 4]",84.20767959710707,4.722957585449651,12,work_charger,180,188,180,"{180: 84.20767959710707, 181: 79.48472201165742, 182: 65.31584925530848, 183: 41.70106132806022, 184: 8.640358229912664, 185: 0, 186: 0, 187: 0}"
257,9,13,42.1342520221329,3,5,18,0.12559890450543323,"[11, 3, 12]",102.57888435355464,4.557160088287823,13,work_charger,229,234,229,"{229: 102.57888435355464, 230: 98.02172426526681, 231: 84.35024400040335, 232: 61.564443558964236, 233: 29.664322940949475}"
258,10,18,40.945785803913246,4,8,24,0.23319934074512264,"[4, 10, 14]",119.0974151151564,4.5477357188368135,18,random,258,266,258,"{258: 119.0974151151564, 259: 114.54967939631958, 260: 100.90647223980915, 261: 78.16779364562507, 262: 46.33364361376738, 263: 5.404022144236052, 264: 0, 265: 0}"
258,6,11,50.38442150719553,3,7,18,0.11012191090741902,"[9, 4, 6]",109.26158115981464,1.1437138602234285,11,random,155,162,155,"{155: 109.26158115981464, 156: 108.11786729959121, 157: 104.68672571892093, 158: 98.96815641780378, 159: 90.96215939623978, 160: 80.66873465422893, 161: 68.08788219177121}"
259,13,22,43.68981689005072,4,10,24,0.15402926950459184,"[10, 8, 13]",94.89267092688945,1.2444118259464143,22,night_charger,334,344,334,"{334: 94.89267092688945, 335: 93.64825910094304}"
259,13,20,49.23116364245628,6,12,24,0.2772526851082653,"[12, 14, 9]",98.03975881875303,1.4259852680178042,20,night_charger,332,344,332,"{332: 98.03975881875303, 333: 96.61377355073523, 334: 92.33581774668181, 335: 85.2058914065928}"
259,7,22,43.57137042284851,3,9,24,0.1812109052995198,"[3, 8, 10]",63.76702642610065,1.9792992738492954,22,night_charger,190,199,190,"{190: 63.76702642610065, 191: 61.78772715225136, 192: 55.84982933070347, 193: 45.953332961456994, 194: 32.09823804451192, 195: 14.284544579868268, 196: 0, 197: 0, 198: 0}"
260,2,20,30.27555327022621,2,9,24,0.24653137868721325,"[12, 14, 11]",91.67531122925391,3.865439142843899,20,night_charger,68,77,68,"{68: 91.67531122925391, 69: 87.80987208641001, 70: 76.21355465787832, 71: 56.88635894365882, 72: 29.828284943751527, 73: 0, 74: 0, 75: 0, 76: 0}"
260,8,21,49.37791076609038,6,12,24,0.13696187704845178,"[9, 7, 1]",117.76737747680467,2.31280700215047,21,night_charger,213,225,213,"{213: 117.76737747680467, 214: 115.4545704746542, 215: 108.51614946820278, 216: 96.95211445745043, 217: 80.76246544239714, 218: 59.947202423042924, 219: 34.50632539938775, 220: 4.439834371431644, 221: 0, 222: 0, 223: 0, 224: 0}"
260,11,19,11.238811839863203,2,7,24,0.24653137868721325,"[7, 13, 14]",88.78220105752783,4.380394618296802,19,night_charger,283,290,283,"{283: 88.78220105752783, 284: 84.40180643923102, 285: 71.26062258434062, 286: 49.35864949285661, 287: 18.695887164778995, 288: 0, 289: 0}"
261,8,7,40.68558281544505,2,3,10,0.39711839718296316,"[5, 7, 3]",121.11232961549275,3.1452341390170093,7,commuter,199,202,199,"{199: 121.11232961549275, 200: 117.96709547647575, 201: 108.53139305942472}"
261,12,11,42.494611483875204,4,7,18,0.22503375840367915,"[3, 0, 12]",63.75502574929482,4.557645723814826,11,commuter,299,306,299,"{299: 63.75502574929482, 300: 59.19738002548, 301: 45.52444285403552, 302: 22.736214234961388, 303: 0, 304: 0, 305: 0}"
261,13,11,65.13774097986898,5,8,19,0.22503375840367915,"[6, 13, 11]",131.56159153470276,4.487655955034546,11,commuter,323,331,323,"{323: 131.56159153470276, 324: 127.07393557966822, 325: 113.61096771456457, 326: 91.17268793939184, 327: 59.75909625415002, 328: 19.370192658839116, 329: 0, 330: 0}"
261,5,14,71.0701068668597,6,7,21,0.22503375840367915,"[3, 9, 11]",108.58923457197281,4.152140183208388,14,commuter,134,141,134,"{134: 108.58923457197281, 135: 104.43709438876442, 136: 91.98067383913926, 137: 71.21997292309732, 138: 42.1549916406386, 139: 4.785729991763105, 140: 0}"
261,2,9,87.31401421200627,7,10,19,0.39711839718296316,"[1, 14, 13]",59.497750804983994,2.3407737406881948,9,commuter,57,67,57,"{57: 59.497750804983994, 58: 57.1569770642958, 59: 50.13465584223121, 60: 38.43078713879024, 61: 22.045370953972878, 62: 0.9784072877791274, 63: 0, 64: 0, 65: 0, 66: 0}"
262,5,13,98.24499746024021,7,12,24,0.13908082813227424,"[4, 8, 9]",123.37360117263562,4.588521865243745,13,weekend_user,133,145,133,"{133: 123.37360117263562, 134: 118.78507930739187, 135: 105.01951371166064, 136: 82.0769043854419, 137: 49.957251328735694, 138: 8.660554541541984, 139: 0, 140: 0, 141: 0, 142: 0, 143: 0, 144: 0}"
262,6,16,57.51959085526642,6,9,24,0.13908082813227424,"[5, 9, 0]",81.5785383439879,4.119370324077267,16,weekend_user,160,169,160,"{160: 81.5785383439879, 161: 77.45916801991063, 162: 65.10105704767884, 163: 44.5042054272925, 164: 15.668613158751626, 165: 0, 166: 0, 167: 0, 168: 0}"
263,5,15,71.05604732391568,6,12,24,0.07391204670785113,"[14, 6, 9]",64.13573748883788,1.265826103828536,15,weekend_user,135,147,135,"{135: 64.13573748883788, 136: 62.86991138500934, 137: 59.07243307352373, 138: 52.74330255438105, 139: 43.8825198275813, 140: 32.490084893124475, 141: 18.565997751010578, 142: 2.110258401239605, 143: 0, 144: 0, 145: 0, 146: 0}"
263,6,16,78.34043154947337,6,12,24,0.07391204670785113,"[14, 4, 6]",116.01879974978584,2.319720083369899,16,weekend_user,160,172,160,"{160: 116.01879974978584, 161: 113.69907966641594, 162: 106.73991941630625, 163: 95.14131899945676, 164: 78.90327841586745, 165: 58.02579766553836, 166: 32.508876748469476, 167: 2.3525156646607854, 168: 0, 169: 0, 170: 0, 171: 0}"
264,11,21,41.5439717070761,6,12,24,0.1618396284421495,"[9, 7, 3]",96.43326526180343,1.6575972207010419,21,night_charger,285,297,285,"{285: 96.43326526180343, 286: 94.77566804110239, 287: 89.80287637899926, 288: 81.51489027549405, 289: 69.91170973058675, 290: 54.993334744277384, 291: 36.75976531656592, 292: 15.211001447452375, 293: 0, 294: 0, 295: 0, 296: 0}"
264,0,21,46.31925621876577,4,9,24,0.1618396284421495,"[7, 3, 14]",62.957866408407966,1.4465072340541627,21,night_charger,21,30,21,"{21: 62.957866408407966, 22: 61.51135917435381, 23: 57.171837472191314, 24: 49.9393013019205, 25: 39.81375066354136, 26: 26.795185557053898, 27: 10.883605982458107, 28: 0, 29: 0}"
264,2,20,30.66321230362688,4,9,24,0.29131133119586916,"[9, 11, 13]",78.26556527573446,1.7356482049313002,20,night_charger,68,77,68,"{68: 78.26556527573446, 69: 76.52991707080317, 70: 71.32297245600925, 71: 62.64473143135276, 72: 50.495193996833656, 73: 34.874360152451956, 74: 15.782229898207653, 75: 0, 76: 0}"
265,1,13,53.39934493796101,6,10,23,0.08684023118539959,"[5, 9, 1]",59.92933462968036,3.8070190890339934,13,work_charger,37,47,37,"{37: 59.92933462968036, 38: 56.12231554064637, 39: 44.70125827354439, 40: 25.666162828374418, 41: 0, 42: 0, 43: 0, 44: 0, 45: 0, 46: 0}"
265,0,10,48.546353640726906,3,8,18,0.08684023118539959,"[3, 10, 6]",64.70300092151462,2.3984069296171464,10,work_charger,10,18,10,"{10: 64.70300092151462, 11: 62.30459399189747, 12: 55.10937320304603, 13: 43.1173385549603, 14: 26.328490047640273, 15: 4.742827681085956, 16: 0, 17: 0}"
265,12,15,42.85456294416943,2,7,22,0.07381419650758965,"[5, 2, 10]",79.96978313800045,1.6654508972468873,15,work_charger,303,310,303,"{303: 79.96978313800045, 304: 78.30433224075357, 305: 73.3079795490129, 306: 64.98072506277846, 307: 53.322568782050254, 308: 38.33351070682827, 309: 20.013550837112504}"
265,12,11,47.082350615713494,4,8,19,0.07381419650758965,"[11, 13, 12]",124.51992340275278,2.338798778076674,11,work_charger,299,307,299,"{299: 124.51992340275278, 300: 122.1811246246761, 301: 115.16472829044608, 302: 103.47073440006272, 303: 87.099142953526, 304: 66.04995395083594, 305: 40.32316739199253, 306: 9.918783276995754}"
266,10,21,17.095576674921077,2,7,24,0.11561591864527196,"[14, 11, 13]",77.7293896906476,3.735292109814013,21,night_charger,261,268,261,"{261: 77.7293896906476, 262: 73.99409758083358, 263: 62.78822125139154, 264: 44.111760702321476, 265: 17.96471593362339, 266: 0, 267: 0}"
266,5,23,5.0,1,7,24,0.06879147159393681,"[7, 5, 1]",143.94336228961873,3.1941559682847553,23,night_charger,143,150,143,"{143: 143.94336228961873, 144: 140.749206321334, 145: 131.16673841647972, 146: 115.19595857505594, 147: 92.83686679706264, 148: 64.08946308249985, 149: 28.953747431367546}"
266,10,22,28.719585430774888,2,8,24,0.11561591864527196,"[9, 2, 7]",112.91131434804304,4.128916001888493,22,night_charger,262,270,262,"{262: 112.91131434804304, 263: 108.78239834615454, 264: 96.39565034048906, 265: 75.7510703310466, 266: 46.848658317827145, 267: 9.6884143008307, 268: 0, 269: 0}"
267,10,9,37.74060863831162,5,8,17,0.12364036699571125,"[14, 2, 8]",55.68419506815826,1.8266440289228623,9,random,249,257,249,"{249: 55.68419506815826, 250: 53.857551039235396, 251: 48.37761895246681, 252: 39.2443988078525, 253: 26.457890605392464, 254: 10.018094345086702, 255: 0, 256: 0}"
267,0,9,29.997138860050605,3,6,15,0.12364036699571125,"[14, 13, 2]",142.1797756503509,2.8027531544207545,9,random,9,15,9,"{9: 142.1797756503509, 10: 139.37702249593016, 11: 130.96876303266788, 12: 116.95499726056411, 13: 97.33572517961883, 14: 72.11094678983204}"
267,7,21,57.270959264714456,7,8,24,0.08242691133047417,"[14, 2, 12]",113.6136530428131,1.7501121917862434,21,random,189,197,189,"{189: 113.6136530428131, 190: 111.86354085102685, 191: 106.61320427566812, 192: 97.86264331673691, 193: 85.6118579742332, 194: 69.86084824815701, 195: 50.609614138508334, 196: 27.85815564528717}"
268,10,20,54.31829080109474,5,10,24,0.19821324249252542,"[6, 12, 9]",79.84349382175756,2.792523439499071,20,night_charger,260,270,260,"{260: 79.84349382175756, 261: 77.0509703822585, 262: 68.67340006376128, 263: 54.71078286626592, 264: 35.163118789772426, 265: 10.030407834280794, 266: 0, 267: 0, 268: 0, 269: 0}"
268,10,23,50.361075506711366,3,8,24,0.0770829276359821,"[0, 14, 9]",66.02665990405869,1.9486707251943858,23,night_charger,263,271,263,"{263: 66.02665990405869, 264: 64.0779891788643, 265: 58.231977003281145, 266: 48.48862337730922, 267: 34.84792830094852, 268: 17.309891774199045, 269: 0, 270: 0}"
269,13,18,18.293671356026124,2,3,21,0.4214857961441295,"[4, 5, 9]",67.18161783012769,1.41697279553911,18,random,330,333,330,"{330: 67.18161783012769, 331: 65.76464503458858, 332: 61.513726647971254}"
270,8,11,49.61274230640481,3,4,15,0.09913224186823844,"[5, 14, 11]",70.80872148501103,2.5367566082159203,11,random,203,207,203,"{203: 70.80872148501103, 204: 68.27196487679511, 205: 60.66169505214735, 206: 47.97791201106775}"
271,12,17,7.990719958540044,1,5,22,0.4045618699406277,"[4, 14, 1]",53.02771013311261,2.202255540447886,17,work_charger,305,310,305,"{305: 53.02771013311261, 306: 50.82545459266473, 307: 44.21868797132107, 308: 33.207410269081635, 309: 17.791621485946436}"
271,10,11,20.759515163765638,2,6,17,0.2644195228370116,"[11, 13, 0]",112.77570772615965,1.5785133524937898,11,work_charger,251,257,251,"{251: 112.77570772615965, 252: 111.19719437366587, 253: 106.4616543161845, 254: 98.56908755371555, 255: 87.51949408625902, 256: 73.31287391381491}"
271,12,18,43.82665638147377,5,7,24,0.4045618699406277,"[9, 7, 13]",110.86723455998136,1.158661638764861,18,work_charger,306,313,306,"{306: 110.86723455998136, 307: 109.7085729212165, 308: 106.23258800492191, 309: 100.4392798110976, 310: 92.32864833974358, 311: 81.90069359085983, 312: 69.15541556444636}"
271,4,13,34.408443553670764,4,8,21,0.2644195228370116,"[9, 10, 14]",70.70008315580452,4.956156967023183,13,work_charger,109,117,109,"{109: 70.70008315580452, 110: 65.74392618878133, 111: 50.87545528771179, 112: 26.09467045259587, 113: 0, 114: 0, 115: 0, 116: 0}"
272,9,7,56.29662364743595,4,5,12,0.19134352886931721,"[0, 8, 1]",115.90621958253116,3.262094121526289,7,random,223,228,223,"{223: 115.90621958253116, 224: 112.64412546100488, 225: 102.85784309642601, 226: 86.54737248879457, 227: 63.71271363811054}"
272,9,12,51.4515717093977,5,8,20,0.12756235257954482,"[11, 2, 14]",72.39081315411144,2.830997469528797,12,random,228,236,228,"{228: 72.39081315411144, 229: 69.55981568458265, 230: 61.066823275996256, 231: 46.91183592835227, 232: 27.094853641650687, 233: 1.6158764158915062, 234: 0, 235: 0}"
273,2,19,43.71690303471076,3,5,24,0.1425448985051259,"[0, 11, 9]",148.6098513480199,3.357772882416996,19,commuter,67,72,67,"{67: 148.6098513480199, 68: 145.2520784656029, 69: 135.17875981835192, 70: 118.38989540626693, 71: 94.88548522934796}"
273,2,17,43.15728613329139,3,5,22,0.1425448985051259,"[14, 11, 12]",71.72787787671365,4.324027155959098,17,commuter,65,70,65,"{65: 71.72787787671365, 66: 67.40385072075455, 67: 54.43176925287726, 68: 32.81163347308176, 69: 2.5434433813680783}"
273,5,15,52.31238058402551,3,5,20,0.06731286873853168,"[1, 9, 10]",72.03210287124283,2.5764535340509136,15,commuter,135,140,135,"{135: 72.03210287124283, 136: 69.45564933719191, 137: 61.72628873503918, 138: 48.844021064784606, 139: 30.80884632642821}"
273,12,14,29.409578987363645,4,6,20,0.06731286873853168,"[11, 2, 8]",100.8073730318211,1.401257962278454,14,commuter,302,308,302,"{302: 100.8073730318211, 303: 99.40611506954265, 304: 95.20234118270729, 305: 88.19605137131501, 306: 78.38724563536584, 307: 65.77592397485975}"
274,8,17,27.05470979223111,2,4,21,0.3610562536990514,"[11, 2, 9]",141.55373999304496,2.295712326263079,17,commuter,209,213,209,"{209: 141.55373999304496, 210: 139.25802766678189, 211: 132.37089068799264, 212: 120.89232905667724}"
274,2,9,48.333914711846056,6,7,16,0.3008802114158761,"[11, 0, 14]",120.30635376375156,4.796448214910956,9,commuter,57,64,57,"{57: 120.30635376375156, 58: 115.5099055488406, 59: 101.12056090410773, 60: 77.13831982955296, 61: 43.56318232517626, 62: 0.39514839097765275, 63: 0}"
274,1,18,28.579384231137258,2,3,21,0.3610562536990514,"[1, 5, 11]",106.83550459866207,1.434595116531722,18,commuter,42,45,42,"{42: 106.83550459866207, 43: 105.40090948213034, 44: 101.09712413253519}"
274,8,8,73.42680973645645,6,8,16,0.3008802114158761,"[2, 14, 4]",112.82404259422626,2.8744640819999714,8,commuter,200,208,200,"{200: 112.82404259422626, 201: 109.94957851222628, 202: 101.32618626622637, 203: 86.95386585622651, 204: 66.83261728222672, 205: 40.962440544226965, 206: 9.343335642227288, 207: 0}"
274,3,9,53.2507428421894,3,5,14,0.3008802114158761,"[11, 7, 6]",68.48973952231994,2.222949896058495,9,commuter,81,86,81,"{81: 68.48973952231994, 82: 66.26678962626144, 83: 59.59793993808596, 84: 48.483190457793484, 85: 32.92254118538402}"
275,11,11,23.430427757144088,2,3,14,0.13827324908780073,"[14, 1, 2]",118.11770960705276,2.4907043819833516,11,random,275,278,275,"{275: 118.11770960705276, 276: 115.62700522506941, 277: 108.15489207911935}"
275,3,19,25.176037702313067,2,3,22,0.24889184835804135,"[3, 6, 14]",65.80423197763736,3.6858032766217512,19,random,91,94,91,"{91: 65.80423197763736, 92: 62.1184287010156, 93: 51.06101887115035}"
276,12,23,77.40630130019794,4,12,24,0.05596346482838089,"[6, 14, 1]",90.1869515649249,3.9703727385689205,23,night_charger,311,323,311,"{311: 90.1869515649249, 312: 86.21657882635597, 313: 74.30546061064922, 314: 54.45359691780461, 315: 26.66098774782217, 316: 0, 317: 0, 318: 0, 319: 0, 320: 0, 321: 0, 322: 0}"
276,0,22,57.40247325134985,4,9,24,0.0940562434090435,"[4, 13, 3]",69.09688977592495,3.0759818257286597,22,night_charger,22,31,22,"{22: 69.09688977592495, 23: 66.02090795019629, 24: 56.79296247301031, 25: 41.413053344367015, 26: 19.881180564266394, 27: 0, 28: 0, 29: 0, 30: 0}"
276,13,19,72.38087191917306,8,12,24,0.14390605241583657,"[2, 13, 4]",123.11311089644235,4.1196631164216395,19,night_charger,331,343,331,"{331: 123.11311089644235, 332: 118.99344778002072, 333: 106.63445843075579, 334: 86.03614284864759, 335: 57.19850103369612}"
277,0,8,45.65705520540477,4,5,13,0.12339667721093513,"[5, 9, 7]",93.76523647244223,4.421870116464422,8,random,8,13,8,"{8: 93.76523647244223, 9: 89.3433663559778, 10: 76.07775600658454, 11: 53.96840542426243, 12: 23.01531460901147}"
277,9,13,61.16374418612807,8,10,23,0.08226445147395677,"[5, 14, 1]",109.0215235628607,3.726726360449668,13,random,229,239,229,"{229: 109.0215235628607, 230: 105.29479720241102, 231: 94.11461812106202, 232: 75.48098631881368, 233: 49.393901795666004, 234: 15.853364551618995, 235: 0, 236: 0, 237: 0, 238: 0}"
278,11,23,17.002091873760065,1,8,24,0.06970193097859657,"[3, 7, 13]",124.9621155563643,4.0301471471889165,23,night_charger,287,295,287,"{287: 124.9621155563643, 288: 120.93196840917538, 289: 108.84152696760863, 290: 88.69079123166405, 291: 60.47976120134163, 292: 24.208436876641386, 293: 0, 294: 0}"
278,7,20,14.67621340284326,2,10,24,0.1792335368021055,"[9, 1, 6]",100.20576469023182,3.3492686885388037,20,night_charger,188,198,188,"{188: 100.20576469023182, 189: 96.85649600169302, 190: 86.8086899360766, 191: 70.06234649338259, 192: 46.61746567361096, 193: 16.474047476761726, 194: 0, 195: 0, 196: 0, 197: 0}"
278,12,23,24.57057120898437,3,8,24,0.059246641331807084,"[13, 6, 10]",55.11595141962713,2.9207603092881116,23,night_charger,311,319,311,"{311: 55.11595141962713, 312: 52.19519111033902, 313: 43.432910182474686, 314: 28.829108636034125, 315: 8.383786471017345, 316: 0, 317: 0, 318: 0}"
279,11,18,32.60067289118769,2,5,23,0.30430768447281864,"[6, 12, 11]",142.54515922785333,1.2345182363944618,18,random,282,287,282,"{282: 142.54515922785333, 283: 141.31064099145888, 284: 137.60708628227547, 285: 131.43449510030317, 286: 122.79286744554194}"
279,11,8,25.36385914904092,2,3,11,0.25358973706068216,"[2, 5, 9]",120.34631642899991,2.54945934787832,8,random,272,275,272,"{272: 120.34631642899991, 273: 117.79685708112159, 274: 110.14847903748664}"
279,4,14,29.250481402419204,2,6,20,0.16905982470712144,"[9, 11, 10]",77.68067971161537,2.0225746862358505,14,random,110,116,110,"{110: 77.68067971161537, 111: 75.65810502537951, 112: 69.59038096667197, 113: 59.47750753549272, 114: 45.31948473184176, 115: 27.116312555719105}"
280,4,23,37.41449058910747,3,10,24,0.0694484965541126,"[13, 8, 5]",119.3391230881426,1.1789032649724072,23,night_charger,119,129,119,"{119: 119.3391230881426, 120: 118.1602198231702, 121: 114.62351002825297, 122: 108.72899370339094, 123: 100.47667084858409, 124: 89.86654146383242, 125: 76.89860554913594, 126: 61.57286310449465, 127: 43.88931412990854, 128: 23.847958625377615}"
280,10,19,31.01874841279871,2,9,24,0.17858184828200385,"[2, 12, 5]",93.93163078576526,2.295487800082266,19,night_charger,259,268,259,"{259: 93.93163078576526, 260: 91.636142985683, 261: 84.7496795854362, 262: 73.27224058502487, 263: 57.20382598444901, 264: 36.54443578370862, 265: 11.294069982803691, 266: 0, 267: 0}"
280,2,23,30.183960059756473,2,10,24,0.0694484965541126,"[7, 12, 11]",130.3423569098163,2.9523339087885785,23,night_charger,71,81,71,"{71: 130.3423569098163, 72: 127.39002300102771, 73: 118.53302127466198, 74: 103.77135173071909, 75: 83.10501436919904, 76: 56.53400919010183, 77: 24.058336193427465, 78: 0, 79: 0, 80: 0}"
281,1,17,16.29636191425889,1,3,20,0.28568663558431096,"[10, 11, 2]",93.36959170082358,3.4813512217751983,17,commuter,41,44,41,"{41: 93.36959170082358, 42: 89.88824047904838, 43: 79.44418681372278}"
281,3,7,26.70223067216227,3,6,13,0.23807219632025908,"[3, 14, 6]",102.83989834014866,1.4909572781772358,7,commuter,79,85,79,"{79: 102.83989834014866, 80: 101.34894106197143, 81: 96.87606922743973, 82: 89.42128283655354, 83: 78.98458188931289, 84: 65.56596638571777}"
281,0,17,36.762807737919104,4,6,23,0.28568663558431096,"[1, 11, 6]",135.55494904355282,3.955723439944586,17,commuter,17,23,17,"{17: 135.55494904355282, 18: 131.59922560360823, 19: 119.73205528377449, 20: 99.95343808405156, 21: 72.26337400443944, 22: 36.66186304493817}"
281,0,8,25.19361892160714,3,5,13,0.23807219632025908,"[1, 11, 2]",96.77322711144706,2.427927223511031,8,commuter,8,13,8,"{8: 96.77322711144706, 9: 94.34529988793602, 10: 87.06151821740293, 11: 74.92188209984778, 12: 57.92639153527056}"
282,2,10,71.14087233109933,4,7,17,0.09507849347699357,"[12, 3, 2]",124.33154936552712,2.439053846786906,10,random,58,65,58,"{58: 124.33154936552712, 59: 121.89249551874022, 60: 114.5753339783795, 61: 102.38006474444498, 62: 85.30668781693663, 63: 63.35520319585448, 64: 36.52561088119852}"
282,13,20,49.856509283455786,5,6,24,0.14547009501980016,"[6, 3, 11]",76.51872397711779,4.566075264425736,20,random,332,338,332,"{332: 76.51872397711779, 333: 71.95264871269205, 334: 58.25442291941484, 335: 35.424046597286164}"
282,5,9,69.19606512951427,4,8,17,0.12122507918316679,"[14, 2, 1]",85.29533315547775,2.348347363524295,9,random,129,137,129,"{129: 85.29533315547775, 130: 82.94698579195345, 131: 75.90194370138057, 132: 64.16020688375909, 133: 47.72177533908903, 134: 26.586649067370374, 135: 0.7548280686031319, 136: 0}"
283,7,23,53.40308883126221,3,10,24,0.054374571751747994,"[12, 3, 2]",125.06502585026682,1.979188248621182,23,night_charger,191,201,191,"{191: 125.06502585026682, 192: 123.08583760164564, 193: 117.1482728557821, 194: 107.25233161267619, 195: 93.39801387232791, 196: 75.58531963473726, 197: 53.81424889990427, 198: 28.0848016678289, 199: 0, 200: 0}"
283,8,22,28.354069183989196,2,10,24,0.07767795964535427,"[13, 6, 4]",141.6412918100428,2.5517403027154772,22,night_charger,214,224,214,"{214: 141.6412918100428, 215: 139.08955150732731, 216: 131.43433059918087, 217: 118.67562908560349, 218: 100.81344696659515, 219: 77.84778424215585, 220: 49.77864091228561, 221: 16.606016976984407, 222: 0, 223: 0}"
284,3,11,93.74887584231291,6,11,22,0.09481128333450846,"[4, 8, 13]",94.90977254824926,3.7267939796628595,11,work_charger,83,94,83,"{83: 94.90977254824926, 84: 91.1829785685864, 85: 80.00259662959783, 86: 61.36862673128353, 87: 35.28106887364351, 88: 1.7399230566777817, 89: 0, 90: 0, 91: 0, 92: 0, 93: 0}"
284,2,8,58.649882037642385,7,9,17,0.14221692500176267,"[3, 4, 10]",115.96659316907483,1.0704100948053799,8,work_charger,56,65,56,"{56: 115.96659316907483, 57: 114.89618307426944, 58: 111.68495278985331, 59: 106.3329023158264, 60: 98.84003165218874, 61: 89.20634079894033, 62: 77.43182975608116, 63: 63.51649852361121, 64: 47.460347101530516}"
284,12,10,65.89649184328557,6,10,20,0.08058959083433219,"[13, 12, 10]",83.80424159970397,3.8026893793846392,10,work_charger,298,308,298,"{298: 83.80424159970397, 299: 80.00155222031933, 300: 68.59348408216542, 301: 49.58003718524222, 302: 22.961211529549743, 303: 0, 304: 0, 305: 0, 306: 0, 307: 0}"
284,10,8,81.68767967088759,5,10,18,0.14221692500176267,"[13, 2, 12]",95.11735795400168,4.463544362918934,8,work_charger,248,258,248,"{248: 95.11735795400168, 249: 90.65381359108274, 250: 77.26318050232594, 251: 54.945458687731275, 252: 23.700648147298736, 253: 0, 254: 0, 255: 0, 256: 0, 257: 0}"
285,1,13,40.96689623648443,5,6,19,0.08359709357136742,"[1, 11, 13]",115.08383588369067,1.5766402415534784,13,random,37,43,37,"{37: 115.08383588369067, 38: 113.50719564213719, 39: 108.77727491747676, 40: 100.89407370970936, 41: 89.85759201883502, 42: 75.66782984485371}"
285,0,18,35.23672289504425,3,6,24,0.15047476842846136,"[1, 8, 6]",62.67915121609823,1.3213477399974591,18,random,18,24,18,"{18: 62.67915121609823, 19: 61.35780347610077, 20: 57.39376025610839, 21: 50.78702155612109, 22: 41.53758737613888, 23: 29.64545771616175}"
285,12,8,38.264987139204116,4,6,14,0.10658629430349345,"[7, 12, 5]",92.23138778560323,2.013393457891436,8,random,296,302,296,"{296: 92.23138778560323, 297: 90.21799432771179, 298: 84.17781395403749, 299: 74.11084666458031, 300: 60.017092459340255, 301: 41.89655133831733}"
286,3,19,16.72525497575016,3,4,23,0.5366131502572261,"[9, 13, 6]",92.35779290034621,1.6444915868633347,19,commuter,91,95,91,"{91: 92.35779290034621, 92: 90.71330131348287, 93: 85.77982655289287, 94: 77.55736861857619}"
286,12,18,23.1818708148056,3,4,22,0.4561211777186421,"[4, 7, 13]",117.73215879614743,3.4721499222470973,18,commuter,306,310,306,"{306: 117.73215879614743, 307: 114.26000887390033, 308: 103.84355910715904, 309: 86.48280949592356}"
286,8,7,31.61423058576279,2,3,10,0.447177625214355,"[11, 5, 10]",75.86752402794943,3.9086949049686117,7,commuter,199,202,199,"{199: 75.86752402794943, 200: 71.95882912298082, 201: 60.23274440807498}"
286,6,19,36.73174173805612,4,7,24,0.4561211777186421,"[14, 13, 9]",114.69394490806386,4.478467993799477,19,commuter,163,170,163,"{163: 114.69394490806386, 164: 110.21547691426437, 165: 96.78007293286595, 166: 74.38773296386856, 167: 43.03845700727223, 168: 2.732245063076931, 169: 0}"
287,12,14,53.27519454220372,6,7,21,0.08088263254100302,"[12, 1, 11]",75.20970651139756,4.7914051541365295,14,commuter,302,309,302,"{302: 75.20970651139756, 303: 70.41830135726103, 304: 56.044085894851435, 305: 32.087060124168794, 306: 0, 307: 0, 308: 0}"
287,12,13,57.18269540534185,8,10,23,0.08088263254100302,"[2, 3, 11]",68.6500583404804,1.9420578062266514,13,commuter,301,311,301,"{301: 68.6500583404804, 302: 66.70800053425374, 303: 60.88182711557379, 304: 51.17153808444054, 305: 37.57713344085398, 306: 20.098613184814113, 307: 0, 308: 0, 309: 0, 310: 0}"
287,7,17,35.73445176718297,3,4,21,0.17128086891035935,"[12, 9, 6]",66.1677346415746,3.4446534511665234,17,commuter,185,189,185,"{185: 66.1677346415746, 186: 62.723081190408074, 187: 52.3891208369085, 188: 35.165853581075886}"
287,1,18,40.37581226160699,4,7,24,0.17128086891035935,"[8, 10, 7]",133.67173654746227,3.8664251022602003,18,commuter,42,49,42,"{42: 133.67173654746227, 43: 129.80531144520208, 44: 118.20603613842147, 45: 98.87391062712047, 46: 71.80893491129908, 47: 37.01110899095727, 48: 0}"
287,1,18,36.16895075370317,3,6,24,0.17128086891035935,"[10, 7, 8]",126.1313774539245,4.285608574061628,18,commuter,42,48,42,"{42: 126.1313774539245, 43: 121.84576887986287, 44: 108.988943157678, 45: 87.56090028736985, 46: 57.56164026893845, 47: 18.991163102383794}"
288,11,17,10.352616534609329,1,2,19,0.15478266967004325,"[3, 14, 5]",131.59249910219762,1.9868216291001142,17,commuter,281,283,281,"{281: 131.59249910219762, 282: 129.6056774730975}"
288,6,19,18.939496754541942,2,4,23,0.13156526921953676,"[10, 8, 6]",131.29529836472062,2.9797292973569447,19,commuter,163,167,163,"{163: 131.29529836472062, 164: 128.31556906736367, 165: 119.37638117529285, 166: 104.47773468850812}"
288,2,19,32.26439708447217,5,8,24,0.15478266967004325,"[11, 9, 3]",109.48083157798914,4.0215523092221,19,commuter,67,75,67,"{67: 109.48083157798914, 68: 105.45927926876703, 69: 93.39462234110073, 70: 73.28686079499023, 71: 45.13599463043553, 72: 8.94202384743663, 73: 0, 74: 0}"
288,1,9,27.19354301857053,2,4,13,0.12898555805836937,"[3, 11, 13]",53.382164171919925,2.7900027904698046,9,commuter,33,37,33,"{33: 53.382164171919925, 34: 50.59216138145012, 35: 42.22215301004071, 36: 28.272139057691682}"
289,5,19,41.646523131120844,4,9,24,0.40920899884479617,"[14, 5, 0]",121.78297761408913,3.324064944993078,19,night_charger,139,148,139,"{139: 121.78297761408913, 140: 118.45891266909605, 141: 108.48671783411682, 142: 91.86639310915143, 143: 68.5979384941999, 144: 38.68135398926219, 145: 2.1166395943383236, 146: 0, 147: 0}"
289,6,20,45.80714170341015,5,12,24,0.40920899884479617,"[1, 7, 0]",138.15352980116816,2.3729987632223697,20,night_charger,164,176,164,"{164: 138.15352980116816, 165: 135.7805310379458, 166: 128.66153474827868, 167: 116.79654093216683, 168: 100.18554958961025, 169: 78.82856072060892, 170: 52.72557432516285, 171: 21.876590403272047, 172: 0, 173: 0, 174: 0, 175: 0}"
289,7,21,50.42242568450066,3,8,24,0.26745686199006286,"[1, 5, 0]",71.18865394499575,3.145488094896503,21,night_charger,189,197,189,"{189: 71.18865394499575, 190: 68.04316585009924, 191: 58.606701565409736, 192: 42.87926109092722, 193: 20.860844426651703, 194: 0, 195: 0, 196: 0}"
290,2,9,38.96473334874885,2,5,14,0.12448844992229054,"[5, 9, 2]",102.29544551851183,2.400400552844759,9,commuter,57,62,57,"{57: 102.29544551851183, 58: 99.89504496566707, 59: 92.6938433071328, 60: 80.69184054290899, 61: 63.88903667299568}"
290,1,17,83.2560449079944,7,8,24,0.14938613990674868,"[11, 1, 5]",59.72244179264248,2.5583809937545126,17,commuter,41,49,41,"{41: 59.72244179264248, 42: 57.16406079888797, 43: 49.488917817624426, 44: 36.69701284885187, 45: 18.788345892570277, 46: 0, 47: 0, 48: 0}"
290,1,9,79.73262722299215,8,9,18,0.12448844992229054,"[11, 9, 3]",105.2751833235126,4.105242611914583,9,commuter,33,42,33,"{33: 105.2751833235126, 34: 101.16994071159803, 35: 88.85421287585427, 36: 68.32799981628136, 37: 39.591301532879285, 38: 2.6441180256480408, 39: 0, 40: 0, 41: 0}"
291,0,17,44.05513747994328,3,7,24,0.30507049450139845,"[13, 5, 0]",138.58996238957496,1.6980416095634783,17,random,17,24,17,"{17: 138.58996238957496, 18: 136.89192078001147, 19: 131.79779595132106, 20: 123.30758790350366, 21: 111.4212966365593, 22: 96.13892215048801, 23: 77.46046444528974}"
292,9,10,39.526874563324384,5,9,19,0.10013764567174106,"[9, 13, 0]",69.39802121060055,4.945078989182262,10,random,226,235,226,"{226: 69.39802121060055, 227: 64.45294222141828, 228: 49.6177052538715, 229: 24.892310307960187, 230: 0, 231: 0, 232: 0, 233: 0, 234: 0}"
293,12,13,15.294964227705465,1,4,17,0.07497652271015488,"[4, 11, 14]",95.02139309565771,3.997678021604762,13,commuter,301,305,301,"{301: 95.02139309565771, 302: 91.02371507405296, 303: 79.03068100923866, 304: 59.042290901214855}"
293,7,19,35.14224770393472,2,3,22,0.15877381279797503,"[14, 12, 3]",133.57933275778873,3.4308856170478768,19,commuter,187,190,187,"{187: 133.57933275778873, 188: 130.14844714074087, 189: 119.85579028959722}"
293,0,8,46.86921404924634,4,6,14,0.13231151066497918,"[0, 11, 4]",120.5027095552528,4.922444805015635,8,commuter,8,14,8,"{8: 120.5027095552528, 9: 115.58026475023718, 10: 100.81293033519026, 11: 76.20070631011208, 12: 41.743592675002645, 13: 0}"
293,12,13,45.71956713728293,5,8,21,0.07497652271015488,"[13, 10, 12]",139.82696496338443,2.7917680451295444,13,commuter,301,309,301,"{301: 139.82696496338443, 302: 137.03519691825488, 303: 128.65989278286625, 304: 114.70105255721853, 305: 95.15867624131172, 306: 70.03276383514581, 307: 39.32331533872083, 308: 3.030330752036747}"
293,5,13,34.223741967028104,3,4,17,0.07497652271015488,"[3, 6, 2]",66.67332478053433,2.783287128286717,13,commuter,133,137,133,"{133: 66.67332478053433, 134: 63.890037652247614, 135: 55.540176267387466, 136: 41.62374062595388}"
294,10,7,5.0,1,2,9,0.15060273528027288,"[1, 13, 8]",126.64050235684422,1.8616876144291257,7,random,247,249,247,"{247: 126.64050235684422, 248: 124.7788147424151}"
294,1,20,23.024009024241753,2,3,23,0.18072328233632748,"[9, 11, 13]",73.54943957245183,1.677866340778118,20,random,44,47,44,"{44: 73.54943957245183, 45: 71.87157323167371, 46: 66.83797420933936}"
294,10,9,24.845769525867997,3,4,13,0.15060273528027288,"[5, 10, 1]",115.60145795915064,4.69581963929972,9,random,249,253,249,"{249: 115.60145795915064, 250: 110.90563831985092, 251: 96.81817940195175, 252: 73.33908120545316}"
295,11,19,29.046111472006753,3,5,24,0.422914319797934,"[4, 2, 1]",149.51813258283255,4.011950772515396,19,commuter,283,288,283,"{283: 149.51813258283255, 284: 145.50618181031714, 285: 133.47032949277096, 286: 113.41057563019399, 287: 85.32692022258621}"
295,10,9,22.809937944812,3,6,15,0.35242859983161157,"[5, 0, 12]",132.34763759882134,3.713158994308729,9,commuter,249,255,249,"{249: 132.34763759882134, 250: 128.6344786045126, 251: 117.49500162158643, 252: 98.92920665004277, 253: 72.93709368988166, 254: 39.518662741103114}"
295,1,8,7.864590710258199,1,3,11,0.35242859983161157,"[4, 5, 3]",122.53664481494441,4.649755250756561,8,commuter,32,35,32,"{32: 122.53664481494441, 33: 117.88688956418785, 34: 103.93762381191817}"
295,1,7,14.37244360737617,2,3,10,0.35242859983161157,"[4, 6, 14]",114.26925784552185,2.332466231554838,7,commuter,31,34,31,"{31: 114.26925784552185, 32: 111.93679161396702, 33: 104.93939291930249}"
296,6,7,57.19868833975694,4,7,14,0.13714767335332992,"[13, 2, 7]",121.55696354730722,1.440977946722266,7,random,151,158,151,"{151: 121.55696354730722, 152: 120.11598560058495, 153: 115.79305176041815, 154: 108.58816202680683, 155: 98.50131639975096, 156: 85.53251487925057, 157: 69.68175746530564}"
296,0,13,31.38275954863328,4,6,19,0.1075668026300627,"[9, 0, 8]",72.00125986513854,2.216339314046992,13,random,13,19,13,"{13: 72.00125986513854, 14: 69.78492055109155, 15: 63.135902608950566, 16: 52.054206038715606, 17: 36.539830840386664, 18: 16.592777013963733}"
297,8,9,21.6826524555504,2,4,13,0.16989139600833247,"[11, 9, 3]",122.91667028105844,3.866194199658481,9,commuter,201,205,201,"{201: 122.91667028105844, 202: 119.05047608139996, 203: 107.45189348242452, 204: 88.12092248413211}"
297,4,17,23.607087607833247,2,3,20,0.203869675209999,"[12, 14, 13]",127.78924758331542,4.249475211495123,17,commuter,113,116,113,"{113: 127.78924758331542, 114: 123.53977237182029, 115: 110.79134673733492}"
297,4,17,8.7054862305908,1,4,21,0.203869675209999,"[14, 7, 3]",118.36725217395067,4.917503278665818,17,commuter,113,117,113,"{113: 118.36725217395067, 114: 113.44974889528486, 115: 98.6972390592874, 116: 74.10972266595832}"
297,10,17,45.70070193953828,3,4,21,0.203869675209999,"[12, 0, 5]",126.22007729260825,4.8127303876435406,17,commuter,257,261,257,"{257: 126.22007729260825, 258: 121.40734690496471, 259: 106.96915574203409, 260: 82.90550380381639}"
297,6,12,14.910766324336954,2,5,17,0.0962717910713884,"[10, 1, 9]",94.95328459853071,4.24621172271128,12,commuter,156,161,156,"{156: 94.95328459853071, 157: 90.70707287581943, 158: 77.9684377076856, 159: 56.737379094129196, 160: 27.013897035150237}"
298,11,12,33.26266974410316,3,6,18,0.08105996596283888,"[5, 0, 4]",134.96270549444247,4.043950626130437,12,work_charger,276,282,276,"{276: 134.96270549444247, 277: 130.91875486831205, 278: 118.78690298992072, 279: 98.56714985926854, 280: 70.25949547635548, 281: 33.86393984118155}"
298,3,12,48.70985270117746,4,6,18,0.08105996596283888,"[6, 1, 10]",86.1777534438734,1.745460923722069,12,work_charger,84,90,84,"{84: 86.1777534438734, 85: 84.43229252015134, 86: 79.19590974898512, 87: 70.46860513037478, 88: 58.250378664320294, 89: 42.54123035082167}"
298,1,11,58.453611660284125,5,9,20,0.08105996596283888,"[4, 11, 10]",72.06910328390553,3.5942548077426615,11,work_charger,35,44,35,"{35: 72.06910328390553, 36: 68.47484847616288, 37: 57.69208405293489, 38: 39.720810014221584, 39: 14.56102636002295, 40: 0, 41: 0, 42: 0, 43: 0}"
299,6,18,50.66489733328367,3,6,24,0.20743707665020636,"[1, 14, 9]",130.08867704791794,2.6287713987434143,18,commuter,162,168,162,"{162: 130.08867704791794, 163: 127.45990564917453, 164: 119.57359145294429, 165: 106.4297344592272, 166: 88.02833466802332, 167: 64.36939207933258}"
299,0,17,57.7583483554689,5,6,23,0.24404361958847812,"[3, 7, 14]",67.33579302113827,1.5819305983970406,17,commuter,17,23,17,"{17: 67.33579302113827, 18: 65.75386242274124, 19: 61.00807062755011, 20: 53.09841763556491, 21: 42.02490344678562, 22: 27.787528061212257}"
299,3,17,41.357332839474985,5,8,24,0.24404361958847812,"[10, 11, 8]",149.13792184482958,1.1753880748438528,17,commuter,89,97,89,"{89: 149.13792184482958, 90: 147.96253376998573, 91: 144.43636954545417, 92: 138.5594291712349, 93: 130.33171264732795, 94: 119.75321997373325, 95: 106.82395115045088, 96: 91.54390617748079}"
299,4,8,13.179343725838407,2,5,13,0.2033696829903984,"[13, 3, 4]",107.17191004250424,2.37463431865094,8,commuter,104,109,104,"{104: 107.17191004250424, 105: 104.7972757238533, 106: 97.67337276790047, 107: 85.80020117464578, 108: 69.17776094408919}"
299,3,9,23.106329982191944,2,5,14,0.2033696829903984,"[11, 14, 12]",132.91514031551532,4.805622062840634,9,commuter,81,86,81,"{81: 132.91514031551532, 82: 128.1095182526747, 83: 113.69265206415278, 84: 89.66454174994962, 85: 56.02518731006518}"
300,12,15,50.26980787992337,5,9,24,0.12988711136060618,"[12, 11, 14]",75.93813734083905,3.9418290067016852,15,weekend_user,303,312,303,"{303: 75.93813734083905, 304: 71.99630833413737, 305: 60.17082131403231, 306: 40.46167628052388, 307: 12.868873233612085, 308: 0, 309: 0, 310: 0, 311: 0}"
301,6,10,33.515648503221485,4,7,17,0.07847234849090665,"[2, 0, 6]",122.88837076721867,4.9098210733398435,10,random,154,161,154,"{154: 122.88837076721867, 155: 117.97854969387883, 156: 103.24908647385931, 157: 78.69998110716008, 158: 44.33123359378118, 159: 0.1428439337225882, 160: 0}"
301,13,16,25.96874400639975,2,4,20,0.07847234849090665,"[14, 7, 13]",89.55991818498273,1.1051777626735468,16,random,328,332,328,"{328: 89.55991818498273, 329: 88.45474042230919, 330: 85.13920713428854, 331: 79.61331832092081}"
301,1,13,30.559918109376017,2,4,17,0.09232040998930192,"[12, 6, 7]",56.352339750597515,2.1023704665758793,13,random,37,41,37,"{37: 56.352339750597515, 38: 54.24996928402164, 39: 47.942857884294, 40: 37.4310055514146}"
302,3,13,34.12980334712501,2,4,17,0.13404670138572577,"[9, 8, 6]",134.59593654230127,3.5781005426814407,13,work_charger,85,89,85,"{85: 134.59593654230127, 86: 131.01783599961982, 87: 120.28353437157551, 88: 102.3930316581683}"
302,7,13,15.456184315342888,1,3,16,0.13404670138572577,"[9, 2, 8]",117.74346844463005,4.988940286350347,13,work_charger,181,184,181,"{181: 117.74346844463005, 182: 112.75452815827971, 183: 97.78770729922866}"
302,10,12,47.36091137297035,3,6,18,0.13404670138572577,"[13, 2, 0]",79.31181032369487,3.327100239111074,12,work_charger,252,258,252,"{252: 79.31181032369487, 253: 75.9847100845838, 254: 66.00340936725057, 255: 49.367908171695206, 256: 26.078206497917684, 257: 0}"
302,8,9,29.588383867180262,4,9,18,0.20107005207858866,"[5, 14, 0]",127.37317369377926,2.2385332948335726,9,work_charger,201,210,201,"{201: 127.37317369377926, 202: 125.13464039894569, 203: 118.41904051444497, 204: 107.22637404027711, 205: 91.55664097644211, 206: 71.40984132293995, 207: 46.78597507977065, 208: 17.685042246934216, 209: 0}"
303,2,22,55.17980052176057,6,12,24,0.10210025239044528,"[8, 11, 9]",78.66368528482607,3.936461204257676,22,night_charger,70,82,70,"{70: 78.66368528482607, 71: 74.72722408056839, 72: 62.91784046779537, 73: 43.23553444650699, 74: 15.680306016703256, 75: 0, 76: 0, 77: 0, 78: 0, 79: 0, 80: 0, 81: 0}"
303,7,22,35.33925476724201,2,10,24,0.10210025239044528,"[13, 7, 8]",91.5754387675602,2.797747101232182,22,night_charger,190,200,190,"{190: 91.5754387675602, 191: 88.77769166632802, 192: 80.38445036263147, 193: 66.39571485647056, 194: 46.81148514784529, 195: 21.63176123675565, 196: 0, 197: 0, 198: 0, 199: 0}"
303,6,19,58.65254550211135,4,9,24,0.15621338615738126,"[9, 12, 11]",85.03175258723286,2.4873972108158355,19,night_charger,163,172,163,"{163: 85.03175258723286, 164: 82.54435537641703, 165: 75.08216374396952, 166: 62.64517768989034, 167: 45.23339721417949, 168: 22.84682231683697, 169: 0, 170: 0, 171: 0}"
304,12,20,49.651887097461675,3,8,24,0.1561569591165551,"[10, 11, 4]",64.6793759436963,2.167178586894901,20,night_charger,308,316,308,"{308: 64.6793759436963, 309: 62.5121973568014, 310: 56.0106615961167, 311: 45.17476866164219, 312: 30.004518553377885, 313: 10.499911271323775, 314: 0, 315: 0}"
304,9,20,61.56277778108106,8,12,24,0.1837140695488884,"[1, 2, 13]",141.14383079417638,4.7494506891001755,20,night_charger,236,248,236,"{236: 141.14383079417638, 237: 136.3943801050762, 238: 122.14602803777568, 239: 98.3987745922748, 240: 65.15261976857357, 241: 22.407563566671996, 242: 0, 243: 0, 244: 0, 245: 0, 246: 0, 247: 0}"
305,0,11,15.407183719668833,2,6,17,0.08187511048133143,"[13, 2, 8]",95.70252804809394,1.0324752281479794,11,work_charger,11,17,11,"{11: 95.70252804809394, 12: 94.67005281994597, 13: 91.57262713550202, 14: 86.41025099476212, 15: 79.18292439772627, 16: 69.89064734439445}"
305,5,16,62.1880433419346,3,5,21,0.06959384390913173,"[14, 9, 2]",75.85960386306772,2.455046219926943,16,work_charger,136,141,136,"{136: 75.85960386306772, 137: 73.40455764314078, 138: 66.03941898335995, 139: 53.76418788372523, 140: 36.57886434423663}"
305,0,12,26.17640850619816,2,4,16,0.08187511048133143,"[5, 14, 8]",114.68360365975346,2.5488932202807137,12,work_charger,12,16,12,"{12: 114.68360365975346, 13: 112.13471043947274, 14: 104.4880307786306, 15: 91.74356467722703}"
306,6,10,13.162059478439252,2,3,13,0.09119919842181058,"[12, 9, 0]",85.07408988828107,3.7286919129441674,10,random,154,157,154,"{154: 85.07408988828107, 155: 81.3453979753369, 156: 70.1593222365044}"
306,6,7,25.256929923352303,2,3,10,0.13679879763271585,"[3, 1, 5]",127.29335403597555,3.8651773219473533,7,random,151,154,151,"{151: 127.29335403597555, 152: 123.4281767140282, 153: 111.83264474818614}"
306,6,10,28.153941456910946,2,5,15,0.09119919842181058,"[6, 1, 14]",63.850677782515916,2.363542897876738,10,random,154,159,154,"{154: 63.850677782515916, 155: 61.487134884639175, 156: 54.39650619100897, 157: 42.57879170162528, 158: 26.033991416488107}"
307,4,11,74.99282250769808,4,6,17,0.1196906795521913,"[1, 6, 13]",83.94422057373845,1.4947673282695169,11,random,107,113,107,"{107: 83.94422057373845, 108: 82.44945324546893, 109: 77.96515126066038, 110: 70.49131461931279, 111: 60.02794332142618, 112: 46.575037367000526}"
308,3,10,35.821858692429316,2,3,13,0.21177258195039897,"[2, 9, 11]",93.27929242068605,3.242740327557857,10,random,82,85,82,"{82: 93.27929242068605, 83: 90.0365520931282, 84: 80.30833111045462}"
308,0,14,33.17462239676034,3,5,19,0.21177258195039897,"[3, 13, 5]",115.65330699030018,1.6622127190987754,14,random,14,19,14,"{14: 115.65330699030018, 15: 113.9910942712014, 16: 109.00445611390508, 17: 100.6933925184112, 18: 89.05790348471977}"
309,9,18,16.960788106016278,3,5,23,0.4008275396202982,"[5, 11, 4]",61.94032322525405,2.2406088492061054,18,random,234,239,234,"{234: 61.94032322525405, 235: 59.69971437604794, 236: 52.97788782842963, 237: 41.7748435823991, 238: 26.09058163795636}"
309,0,10,20.562829395005668,2,4,14,0.22268196645572122,"[10, 12, 0]",72.02469404313717,3.662136000680056,10,random,10,14,10,"{10: 72.02469404313717, 11: 68.36255804245712, 12: 57.37615004041695, 13: 39.065470037016674}"
309,2,15,25.969537418072907,3,4,19,0.22268196645572122,"[0, 9, 7]",126.12658360984534,4.090525554176567,15,random,63,67,63,"{63: 126.12658360984534, 64: 122.03605805566878, 65: 109.76448139313908, 66: 89.31185362225624}"
310,11,8,87.44004393881387,6,9,17,0.30759457236169246,"[0, 1, 5]",61.01761827329757,2.785334961763312,8,commuter,272,281,272,"{272: 61.01761827329757, 273: 58.23228331153426, 274: 49.876278426244326, 275: 35.94960361742777, 276: 16.452258885084582, 277: 0, 278: 0, 279: 0, 280: 0}"
310,13,12,45.854469944937314,6,8,20,0.1743035910049591,"[12, 9, 6]",51.07389817979825,4.5191808299738385,12,commuter,324,332,324,"{324: 51.07389817979825, 325: 46.55471734982441, 326: 32.9971748599029, 327: 10.4012707100337, 328: 0, 329: 0, 330: 0, 331: 0}"
310,12,17,52.91566173966381,3,4,21,0.31374646380892635,"[4, 8, 14]",145.18083880692424,2.582812617759675,17,commuter,305,309,305,"{305: 145.18083880692424, 306: 142.59802618916456, 307: 134.84958833588553, 308: 121.93552524708717}"
310,0,19,54.178990032602776,5,8,24,0.36911348683403106,"[2, 9, 0]",109.10987992719926,2.927564925081758,19,commuter,19,27,19,"{19: 109.10987992719926, 20: 106.1823150021175, 21: 97.39962022687223, 22: 82.76179560146343, 23: 62.26884112589113, 24: 35.9207568001553, 25: 3.7175426242559695, 26: 0}"
310,12,13,79.3772559985837,5,7,20,0.1743035910049591,"[9, 1, 5]",57.46190555687082,2.3923561290067323,13,commuter,301,308,301,"{301: 57.46190555687082, 302: 55.06954942786408, 303: 47.89248104084389, 304: 35.93070039581023, 305: 19.1842074927631, 306: 0, 307: 0}"
311,7,19,38.08368673869738,4,7,24,0.3563073625700324,"[12, 13, 8]",125.3585358999495,4.008177347530508,19,commuter,187,194,187,"{187: 125.3585358999495, 188: 121.350358552419, 189: 109.32582650982746, 190: 89.28493977217494, 191: 61.22769833946137, 192: 25.15410221168679, 193: 0}"
311,7,9,30.08336753631926,4,7,16,0.29692280214169364,"[3, 12, 8]",65.55165479052259,1.8251929489790504,9,commuter,177,184,177,"{177: 65.55165479052259, 178: 63.72646184154354, 179: 58.250882994606386, 180: 49.124918249711136, 181: 36.348567606857785, 182: 19.92183106604633, 183: 0}"
311,10,9,35.27145234453786,3,4,13,0.29692280214169364,"[4, 13, 5]",118.94117084305128,3.393011722068208,9,commuter,249,253,249,"{249: 118.94117084305128, 250: 115.54815912098307, 251: 105.36912395477844, 252: 88.40406534443741}"
311,7,9,38.591015805123554,6,9,18,0.29692280214169364,"[4, 6, 13]",91.90550505890891,1.8929175674437326,9,commuter,177,186,177,"{177: 91.90550505890891, 178: 90.01258749146518, 179: 84.33383478913399, 180: 74.86924695191533, 181: 61.61882397980919, 182: 44.5825658728156, 183: 23.760472630934544, 184: 0, 185: 0}"
312,7,19,17.20237553238195,1,8,24,0.18533573691327124,"[9, 7, 3]",142.17456779348555,3.261796940937936,19,night_charger,187,195,187,"{187: 142.17456779348555, 188: 138.91277085254762, 189: 129.1273800297338, 190: 112.81839532504412, 191: 89.98581673847858, 192: 60.62964427003715, 193: 24.749877919719864, 194: 0}"
312,11,19,46.625738994670456,3,10,24,0.18533573691327124,"[8, 7, 9]",69.27904358191059,1.5301951164194976,19,night_charger,283,293,283,"{283: 69.27904358191059, 284: 67.7488484654911, 285: 63.1582631162326, 286: 55.50728753413511, 287: 44.795921719198624, 288: 31.024165671423148, 289: 14.192019390808674, 290: 0, 291: 0, 292: 0}"
312,0,21,32.87142528305443,2,7,24,0.10296429828515068,"[13, 6, 9]",140.03777288809312,2.6324025938968227,21,night_charger,21,28,21,"{21: 140.03777288809312, 22: 137.4053702941963, 23: 129.50816251250583, 24: 116.34614954302171, 25: 97.91933138574396, 26: 74.22770804067255, 27: 45.27127950780749}"
313,0,17,34.60127980048832,4,7,24,0.1675486889468624,"[7, 14, 10]",86.73911816229793,2.0312779083472714,17,random,17,24,17,"{17: 86.73911816229793, 18: 84.70784025395065, 19: 78.61400652890885, 20: 68.45761698717249, 21: 54.238671628741585, 22: 35.95717045361614, 23: 13.61311346179616}"
313,2,9,32.91905521466229,2,3,12,0.13962390745571865,"[2, 0, 7]",110.10970613725092,3.5168006297986434,9,random,57,60,57,"{57: 110.10970613725092, 58: 106.59290550745229, 59: 96.04250361805634}"
314,0,11,47.35043817024349,4,7,18,0.11583125317767126,"[12, 10, 8]",109.76821280278075,1.8117035428079529,11,work_charger,11,18,11,"{11: 109.76821280278075, 12: 107.9565092599728, 13: 102.52139863154895, 14: 93.46288091750918, 15: 80.7809561178535, 16: 64.47562423258194, 17: 44.54688526169444}"
314,8,12,35.774468689940164,5,7,19,0.11583125317767126,"[3, 12, 10]",98.41175310016499,4.63549910494773,12,work_charger,204,211,204,"{204: 98.41175310016499, 205: 93.77625399521726, 206: 79.86975668037407, 207: 56.69226115563542, 208: 24.24376742100131, 209: 0, 210: 0}"
314,5,15,52.02606903463789,5,9,24,0.09845656520102058,"[12, 7, 2]",56.58377421643025,1.170978426098436,15,work_charger,135,144,135,"{135: 56.58377421643025, 136: 55.41279579033181, 137: 51.899860512036504, 138: 46.04496838154432, 139: 37.848119398855275, 140: 27.30931356396935, 141: 14.428550876886554, 142: 0, 143: 0}"
314,8,13,32.810043999248954,5,10,23,0.11583125317767126,"[6, 9, 10]",96.66136228021257,2.3468663891203803,13,work_charger,205,215,205,"{205: 96.66136228021257, 206: 94.31449589109219, 207: 87.27389672373106, 208: 75.53956477812915, 209: 59.11150005428649, 210: 37.98970255220306, 211: 12.174172271878888, 212: 0, 213: 0, 214: 0}"
315,5,23,58.80916851500966,5,10,24,0.05118935384208862,"[5, 7, 1]",105.316327967139,2.3147895488690544,23,night_charger,143,153,143,"{143: 105.316327967139, 144: 103.00153841826994, 145: 96.05716977166279, 146: 84.48322202731751, 147: 68.27969518523413, 148: 47.44658924541264, 149: 21.983904207853044, 150: 0, 151: 0, 152: 0}"
315,10,22,56.58343690590957,5,10,24,0.08603252746569516,"[6, 7, 8]",115.93141943788129,2.863832936862059,22,night_charger,262,272,262,"{262: 115.93141943788129, 263: 113.06758650101924, 264: 104.47608769043305, 265: 90.15692300612275, 266: 70.11009244808835, 267: 44.335596016329816, 268: 12.83343371084716, 269: 0, 270: 0, 271: 0}"
315,4,22,59.04300071173044,5,12,24,0.08603252746569516,"[12, 4, 13]",67.25049469848929,1.9667192628286907,22,night_charger,118,130,118,"{118: 67.25049469848929, 119: 65.2837754356606, 120: 59.38361764717453, 121: 49.550021333031076, 122: 35.78298649323024, 123: 18.082513127772025, 124: 0, 125: 0, 126: 0, 127: 0, 128: 0, 129: 0}"
316,12,19,37.82762415602245,4,9,24,0.11550686798723446,"[7, 8, 11]",121.12071607340226,2.5105163205605785,19,weekend_user,307,316,307,"{307: 121.12071607340226, 308: 118.61019975284168, 309: 111.07865079115994, 310: 98.52606918835706, 311: 80.95245494443301, 312: 58.3578080593878, 313: 30.742128533221432, 314: 0, 315: 0}"
316,12,20,60.25905240143444,5,11,24,0.11550686798723446,"[2, 1, 13]",58.0704894928163,4.933848141537611,20,weekend_user,308,319,308,"{308: 58.0704894928163, 309: 53.13664135127869, 310: 38.335096926665855, 311: 13.665856218977801, 312: 0, 313: 0, 314: 0, 315: 0, 316: 0, 317: 0, 318: 0}"
317,0,18,68.84748551306883,5,7,24,0.1560676552048741,"[9, 3, 10]",147.51145070457258,4.5878524868424675,18,commuter,18,25,18,"{18: 147.51145070457258, 19: 142.9235982177301, 20: 129.16004075720272, 21: 106.22077832299038, 22: 74.1058109150931, 23: 32.81513853351089, 24: 0}"
317,10,8,68.77798742694891,6,8,16,0.13005637933739506,"[6, 2, 0]",141.10212987647947,2.289674935547728,8,commuter,248,256,248,"{248: 141.10212987647947, 249: 138.81245494093173, 250: 131.94343013428855, 251: 120.49505545654992, 252: 104.46733090771582, 253: 83.86025648778627, 254: 58.67383219676125, 255: 28.908058034640803}"
317,9,9,47.98516312137691,5,7,16,0.13005637933739506,"[7, 4, 9]",59.29802764447912,3.484490411647241,9,commuter,225,232,225,"{225: 59.29802764447912, 226: 55.81353723283188, 227: 45.36006599789016, 228: 27.937613939653954, 229: 3.546181058123267, 230: 0, 231: 0}"
317,13,12,40.36792900652247,3,5,17,0.0736986149578572,"[5, 1, 13]",111.14308072278888,1.4628531982758783,12,commuter,324,329,324,"{324: 111.14308072278888, 325: 109.680227524513, 326: 105.29166792968536, 327: 97.97740193830597, 328: 87.73742955037483}"
317,9,18,69.1871687989219,4,5,23,0.1560676552048741,"[2, 13, 4]",144.65083782919413,1.286991856902855,18,commuter,234,239,234,"{234: 144.65083782919413, 235: 143.36384597229127, 236: 139.5028704015827, 237: 133.06791111706843, 238: 124.05896811874845}"
318,0,9,43.147514145741745,3,5,14,0.14588378584129563,"[8, 0, 7]",99.14782344184465,1.7841168068140307,9,commuter,9,14,9,"{9: 99.14782344184465, 10: 97.36370663503062, 11: 92.01135621458853, 12: 83.09077218051837, 13: 70.60195453282016}"
318,7,7,34.16358867731164,3,6,13,0.14588378584129563,"[12, 2, 4]",113.26436363041964,1.0041172622614667,7,commuter,175,181,175,"{175: 113.26436363041964, 176: 112.26024636815816, 177: 109.24789458137377, 178: 104.22730827006643, 179: 97.19848743423617, 180: 88.16143207388296}"
318,7,7,11.999876793505337,1,3,10,0.14588378584129563,"[2, 3, 13]",117.85298454369423,4.306548591084022,7,commuter,175,178,175,"{175: 117.85298454369423, 176: 113.54643595261021, 177: 100.62679017935815}"
318,8,19,29.880439471956606,3,6,24,0.1750605430095548,"[12, 14, 6]",127.4676768373454,4.436153478185198,19,commuter,211,217,211,"{211: 127.4676768373454, 212: 123.03152335916019, 213: 109.7230629246046, 214: 87.54229553367861, 215: 56.489221186382224, 216: 16.563839882715442}"
319,12,11,24.799170465569652,2,4,15,0.09817214634678521,"[0, 4, 6]",74.10297323359256,1.2584185923452837,11,commuter,299,303,299,"{299: 74.10297323359256, 300: 72.84455464124729, 301: 69.06929886421143, 302: 62.77720590248501}"
319,6,12,22.32770961275802,2,5,17,0.09817214634678521,"[14, 11, 13]",70.90712853003491,4.978262272834307,12,commuter,156,161,156,"{156: 70.90712853003491, 157: 65.92886625720061, 158: 50.99407943869768, 159: 26.102768074526146, 160: 0}"
319,12,12,18.386569100209666,2,4,16,0.09817214634678521,"[1, 12, 7]",95.13622752009461,4.3911723600521215,12,commuter,300,304,300,"{300: 95.13622752009461, 301: 90.74505516004248, 302: 77.57153807988612, 303: 55.61567627962551}"
319,5,10,24.844918720651897,2,3,13,0.09817214634678521,"[1, 2, 8]",142.48741686627324,1.989004359535126,10,commuter,130,133,130,"{130: 142.48741686627324, 131: 140.4984125067381, 132: 134.53139942813274}"
319,13,10,41.95659844151143,4,6,16,0.09817214634678521,"[9, 13, 2]",51.52165296909772,3.760933333658093,10,commuter,322,328,322,"{322: 51.52165296909772, 323: 47.76071963543963, 324: 36.47791963446535, 325: 17.673252966174886, 326: 0, 327: 0}"
320,13,15,35.6414381464964,4,7,22,0.1086697486120666,"[4, 1, 2]",56.22226953788427,1.3505695153189605,15,random,327,334,327,"{327: 56.22226953788427, 328: 54.871700022565314, 329: 50.81999147660843, 330: 44.067143900013626, 331: 34.613157292780905, 332: 22.458031654910258, 333: 7.601766986401692}"
321,1,12,32.882225358731745,4,9,21,0.2393915353490437,"[11, 8, 1]",120.97672839415536,2.451314898907494,12,work_charger,36,45,36,"{36: 120.97672839415536, 37: 118.52541349524786, 38: 111.17146879852538, 39: 98.91489430398791, 40: 81.75569001163545, 41: 59.693855921468, 42: 32.72939203348557, 43: 0.8622983476881387, 44: 0}"
321,0,12,31.711877959255744,2,7,19,0.2393915353490437,"[2, 9, 5]",55.61949367332569,4.6807703990682725,12,work_charger,12,19,12,"{12: 55.61949367332569, 13: 50.93872327425742, 14: 36.8964120770526, 15: 13.49256008171124, 16: 0, 17: 0, 18: 0}"
321,12,17,39.973483214633724,3,8,24,0.36626904908403685,"[3, 13, 14]",76.91536409710898,4.016807463541403,17,work_charger,305,313,305,"{305: 76.91536409710898, 306: 72.89855663356758, 307: 60.84813424294337, 308: 40.76409692523635, 309: 12.646444680446535, 310: 0, 311: 0, 312: 0}"
321,0,10,65.01635270314654,7,10,20,0.2393915353490437,"[9, 1, 8]",107.26341090497715,2.1274389200026302,10,work_charger,10,20,10,"{10: 107.26341090497715, 11: 105.13597198497452, 12: 98.75365522496662, 13: 88.11646062495348, 14: 73.22438818493507, 15: 54.07743790491139, 16: 30.675609784882454, 17: 3.018903824848266, 18: 0, 19: 0}"
322,2,19,41.01730730057107,3,4,23,0.2456660141806656,"[3, 8, 9]",145.28045855639408,3.415581200579089,19,commuter,67,71,67,"{67: 145.28045855639408, 68: 141.864877355815, 69: 131.61813375407772, 70: 114.54022775118227}"
322,4,8,31.174548661878234,3,4,12,0.20472167848388798,"[11, 1, 6]",147.091978852688,3.2087826054757507,8,commuter,104,108,104,"{104: 147.091978852688, 105: 143.88319624721223, 106: 134.256848430785, 107: 118.21293540340623}"
322,6,14,44.793672512074494,5,7,21,0.11600895114086986,"[7, 13, 9]",136.89994079518027,4.05317421023579,14,commuter,158,165,158,"{158: 136.89994079518027, 159: 132.84676658494448, 160: 120.68724395423712, 161: 100.42137290305817, 162: 72.04915343140763, 163: 35.57058553928552, 164: 0}"
322,2,8,32.33138653732696,2,4,12,0.20472167848388798,"[13, 7, 14]",92.58171465117016,4.159061951178666,8,commuter,56,60,56,"{56: 92.58171465117016, 57: 88.42265269999149, 58: 75.9454668464555, 59: 55.15015709056217}"
323,4,11,30.975767915734536,2,4,15,0.08042024595994544,"[11, 3, 8]",140.10384977340232,4.508154516173218,11,work_charger,107,111,107,"{107: 140.10384977340232, 108: 135.5956952572291, 109: 122.07123170870945, 110: 99.53045912784336}"
323,2,10,35.826921761919166,4,7,17,0.08042024595994544,"[11, 13, 6]",60.544943423635765,3.0603397708705375,10,work_charger,58,65,58,"{58: 60.544943423635765, 59: 57.48460365276523, 60: 48.30358434015361, 61: 33.001885485800926, 62: 11.579507089707164, 63: 0, 64: 0}"
323,6,10,17.11275086462792,2,6,16,0.06835720906595363,"[11, 6, 7]",53.286272579513984,1.5436295291707958,10,work_charger,154,160,154,"{154: 53.286272579513984, 155: 51.74264305034319, 156: 47.1117544628308, 157: 39.39360681697682, 158: 28.58820011278125, 159: 14.695534350244088}"
323,6,17,46.15335126899384,5,8,24,0.12304297631871652,"[9, 6, 7]",81.98359232919671,2.3059773106530064,17,work_charger,161,169,161,"{161: 81.98359232919671, 162: 79.6776150185437, 163: 72.75968308658469, 164: 61.22979653331966, 165: 45.08795535874861, 166: 24.334159562871548, 167: 0, 168: 0}"
324,2,20,52.54933262890421,4,5,24,0.15770715341868172,"[0, 2, 1]",128.54450308522394,1.4499918312555415,20,random,68,73,68,"{68: 128.54450308522394, 69: 127.09451125396839, 70: 122.74453576020177, 71: 115.49457660392406, 72: 105.34463378513527}"
324,1,19,38.82045123313074,3,7,24,0.15770715341868172,"[2, 8, 6]",56.081631184979976,2.1126156673445378,19,random,43,50,43,"{43: 56.081631184979976, 44: 53.96901551763544, 45: 47.63116851560183, 46: 37.06809017887913, 47: 22.279780507467372, 48: 3.2662395013665346, 49: 0}"
325,1,19,26.19106086728992,2,7,24,0.327639267242492,"[5, 3, 8]",141.02271992824473,1.1741863113735014,19,night_charger,43,50,43,"{43: 141.02271992824473, 44: 139.84853361687124, 45: 136.3259746827507, 46: 130.4550431258832, 47: 122.2357389462687, 48: 111.66806214390719, 49: 98.75201271879868}"
325,3,22,11.1809400273928,1,6,24,0.18202181513471777,"[13, 14, 9]",69.49273305981309,3.8392243556159604,22,night_charger,94,100,94,"{94: 69.49273305981309, 95: 65.65350870419714, 96: 54.135835637349246, 97: 34.939713859269446, 98: 8.065143369957724, 99: 0}"
325,1,22,44.125455528943,3,11,24,0.18202181513471777,"[5, 11, 9]",60.75114130571369,3.24537779152351,22,night_charger,46,57,46,"{46: 60.75114130571369, 47: 57.50576351419018, 48: 47.76963013961965, 49: 31.5427411820021, 50: 8.825096641337531, 51: 0, 52: 0, 53: 0, 54: 0, 55: 0, 56: 0}"
326,1,21,65.57044161698508,8,12,24,0.12500920098494184,"[7, 12, 11]",100.72136816780898,1.9648925004375868,21,night_charger,45,57,45,"{45: 100.72136816780898, 46: 98.75647566737139, 47: 92.86179816605863, 48: 83.03733566387069, 49: 69.28308816080758, 50: 51.599055656869304, 51: 29.985238152055857, 52: 4.441635646367217, 53: 0, 54: 0, 55: 0, 56: 0}"
326,6,20,30.714452937114782,4,12,24,0.191264077506961,"[5, 7, 9]",144.40666492637297,4.7914082922873344,20,night_charger,164,176,164,"{164: 144.40666492637297, 165: 139.61525663408563, 166: 125.24103175722362, 167: 101.28399029578696, 168: 67.74413224977562, 169: 24.621457619189613, 170: 0, 171: 0, 172: 0, 173: 0, 174: 0, 175: 0}"
327,13,16,19.74376938760767,1,2,18,0.07390940997007754,"[3, 13, 1]",80.83892129016607,2.152580994446113,16,commuter,328,330,328,"{328: 80.83892129016607, 329: 78.68634029571996}"
327,5,13,30.23707313995362,4,6,19,0.07390940997007754,"[12, 9, 14]",80.01820208932946,1.4736827760730726,13,commuter,133,139,133,"{133: 80.01820208932946, 134: 78.54451931325639, 135: 74.12347098503717, 136: 66.7550571046718, 137: 56.4392776721603, 138: 43.176132687502644}"
327,13,17,21.05108158040924,2,5,22,0.13303693794613958,"[8, 6, 13]",63.33883893171166,4.566337245900102,17,commuter,329,334,329,"{329: 63.33883893171166, 330: 58.77250168581156, 331: 45.07348994811126, 332: 22.241803718610747, 333: 0}"
327,3,7,26.33128096104912,2,3,10,0.13042837053543094,"[5, 10, 1]",133.18704093509638,2.241320028538252,7,commuter,79,82,79,"{79: 133.18704093509638, 80: 130.94572090655814, 81: 124.22176082094337}"
328,8,15,67.06519274935424,4,7,22,0.24955212373833252,"[4, 11, 1]",99.28791795440839,3.752148534212515,15,random,207,214,207,"{207: 99.28791795440839, 208: 95.53576942019588, 209: 84.27932381755832, 210: 65.51858114649575, 211: 39.25354140700814, 212: 5.484204599095506, 213: 0}"
329,1,16,41.839577284019335,5,7,23,0.13874899925685,"[8, 13, 1]",55.58882682530752,1.9332091502331656,16,random,40,47,40,"{40: 55.58882682530752, 41: 53.65561767507435, 42: 47.85599022437486, 43: 38.18994447320903, 44: 24.65748042157687, 45: 7.258598069478381, 46: 0}"
329,13,17,30.770221421485168,3,4,21,0.21228596886298048,"[11, 13, 12]",78.17295914496609,3.5741419131429235,17,random,329,333,329,"{329: 78.17295914496609, 330: 74.59881723182316, 331: 63.87639149239439, 332: 46.00568192667978}"
330,0,19,23.493617190935502,2,3,22,0.1518763602635508,"[7, 12, 14]",57.20266657303363,1.1816406243348148,19,commuter,19,22,19,"{19: 57.20266657303363, 20: 56.02102594869882, 21: 52.47610407569437}"
330,13,19,19.933456000667938,1,3,22,0.12909490622401817,"[4, 13, 8]",93.63858749678805,2.6619857821473554,19,commuter,331,334,331,"{331: 93.63858749678805, 332: 90.9766017146407, 333: 82.99064436819863}"
330,3,18,26.449923813023258,3,4,22,0.1518763602635508,"[8, 3, 12]",123.59748710048278,3.120372253899066,18,commuter,90,94,90,"{90: 123.59748710048278, 91: 120.47711484658372, 92: 111.11599808488651, 93: 95.51413681539118}"
331,13,11,50.636101270110366,4,6,17,0.11529626023402437,"[3, 14, 13]",102.86734431337663,3.1206012811516533,11,random,323,329,323,"{323: 102.86734431337663, 324: 99.74674303222498, 325: 90.38493918877002, 326: 74.78193278301175, 327: 52.93772381495018, 328: 24.85231228458531}"
331,11,9,30.33313950638074,2,6,15,0.20346398864827828,"[4, 11, 9]",109.80458224670235,1.7685713947862176,9,random,273,279,273,"{273: 109.80458224670235, 274: 108.03601085191613, 275: 102.73029666755748, 276: 93.88743969362639, 277: 81.50743993012287, 278: 65.59029737704691}"
331,10,11,48.52878379342114,4,8,19,0.13564265909885218,"[2, 8, 9]",62.15833070862409,1.009874011943984,11,random,251,259,251,"{251: 62.15833070862409, 252: 61.14845669668011, 253: 58.11883466084816, 254: 53.06946460112824, 255: 46.00034651752035, 256: 36.911480410024495, 257: 25.80286627864067, 258: 12.674504123368877}"
332,1,8,32.823122587095476,2,3,11,0.3650097044068112,"[0, 5, 14]",123.80418050142062,2.3093821655960665,8,commuter,32,35,32,"{32: 123.80418050142062, 33: 121.49479833582456, 34: 114.56665183903635}"
332,6,19,28.987619020335032,5,8,24,0.37230989849494744,"[12, 8, 13]",88.30438128500836,1.607545608069449,19,commuter,163,171,163,"{163: 88.30438128500836, 164: 86.69683567693892, 165: 81.87419885273056, 166: 73.83647081238333, 167: 62.58365155589718, 168: 48.115741083272134, 169: 30.432739394508197, 170: 9.534646489605365}"
332,9,19,51.07224743379696,4,5,24,0.43801164528817355,"[2, 5, 11]",88.69610795177373,4.334788867976105,19,commuter,235,240,235,"{235: 88.69610795177373, 236: 84.36131908379762, 237: 71.3569524798693, 238: 49.683008139988786, 239: 19.33948606415605}"
332,11,19,29.956334402916056,2,3,22,0.43801164528817355,"[11, 5, 4]",110.4726119632974,3.8024488945532657,19,commuter,283,286,283,"{283: 110.4726119632974, 284: 106.67016306874413, 285: 95.26281638508434}"
332,5,18,14.029442149376184,1,4,22,0.37230989849494744,"[0, 7, 4]",96.42251661891989,2.312316871588666,18,commuter,138,142,138,"{138: 96.42251661891989, 139: 94.11019974733122, 140: 87.17324913256522, 141: 75.61166477462189}"
333,7,21,47.40190609054192,6,9,24,0.11417249407302213,"[3, 4, 12]",52.72876506505656,1.9207251154850309,21,random,189,198,189,"{189: 52.72876506505656, 190: 50.80803994957152, 191: 45.045864603116435, 192: 35.44223902569128, 193: 21.997163217296062, 194: 4.710637177930785, 195: 0, 196: 0, 197: 0}"
333,4,16,30.351457725744204,2,5,21,0.11417249407302213,"[11, 2, 1]",136.1498622854022,4.348698281377775,16,random,112,117,112,"{112: 136.1498622854022, 113: 131.80116400402443, 114: 118.75506915989111, 115: 97.01157775300223, 116: 66.5706897833578}"
333,4,13,23.507492046669633,3,4,17,0.11417249407302213,"[2, 10, 7]",135.4585768809481,1.3246369964988598,13,random,109,113,109,"{109: 135.4585768809481, 110: 134.13393988444923, 111: 130.16002889495266, 112: 123.53684391245837}"
334,4,20,72.63939972929235,5,9,24,0.15061805765357694,"[13, 9, 7]",149.04570074037514,2.7886484425553877,20,random,116,125,116,"{116: 149.04570074037514, 117: 146.25705229781974, 118: 137.8911069701536, 119: 123.94786475737665, 120: 104.42732565948893, 121: 79.32948967649045, 122: 48.65435680838118, 123: 12.401927055161138, 124: 0}"
334,0,18,38.14456484918176,3,7,24,0.15061805765357694,"[14, 6, 0]",128.16812079596195,3.7970991813415607,18,random,18,25,18,"{18: 128.16812079596195, 19: 124.37102161462039, 20: 112.97972407059571, 21: 93.99422816388791, 22: 67.41453389449698, 23: 33.24064126242294, 24: 0}"
334,0,17,70.31187814995549,5,6,23,0.15061805765357694,"[7, 6, 13]",74.39634814185632,2.1430756008796075,17,random,17,23,17,"{17: 74.39634814185632, 18: 72.25327254097671, 19: 65.82404573833789, 20: 55.10866773393985, 21: 40.1071385277826, 22: 20.819458119866134}"
335,13,20,35.72413711078512,2,5,24,0.16565274262816346,"[11, 6, 12]",84.8790588532021,4.032553846037151,20,random,332,337,332,"{332: 84.8790588532021, 333: 80.84650500716495, 334: 68.7488434690535, 335: 48.58607423886774}"
336,11,19,10.265220668184153,1,7,24,0.3216511761286505,"[13, 3, 10]",57.5238507751913,3.3941904719203912,19,night_charger,283,290,283,"{283: 57.5238507751913, 284: 54.12966030327091, 285: 43.947088887509736, 286: 26.976136527907776, 287: 3.216803224465039, 288: 0, 289: 0}"
336,0,20,14.78359424183946,2,7,24,0.3216511761286505,"[8, 13, 5]",148.3415115266428,2.2155502718832873,20,night_charger,20,27,20,"{20: 148.3415115266428, 21: 146.12596125475952, 22: 139.47931043910964, 23: 128.40155907969321, 24: 112.89270717651019, 25: 92.95275472956061, 26: 68.58170173884444}"
337,8,9,34.59066313164731,2,4,13,0.2090379790298517,"[8, 0, 5]",61.15689923848271,2.664750643734783,9,commuter,201,205,201,"{201: 61.15689923848271, 202: 58.492148594747924, 203: 50.49789666354358, 204: 37.17414344486966}"
337,9,18,49.09416229526042,3,5,23,0.25084557483582204,"[4, 11, 8]",80.0529549717147,2.1805041760243085,18,commuter,234,239,234,"{234: 80.0529549717147, 235: 77.87245079569038, 236: 71.33093826761747, 237: 60.42841738749593, 238: 45.16488815532576}"
337,3,8,14.1920189464265,2,4,12,0.2090379790298517,"[9, 12, 5]",107.77914549604904,3.9212211079242127,8,commuter,80,84,80,"{80: 107.77914549604904, 81: 103.85792438812483, 82: 92.0942610643522, 83: 72.48815552473113}"
337,3,18,19.68866301475768,2,5,23,0.25084557483582204,"[9, 11, 5]",144.43976950101415,3.8370483751180005,18,commuter,90,95,90,"{90: 144.43976950101415, 91: 140.60272112589615, 92: 129.09157600054215, 93: 109.90633412495215, 94: 83.04699549912615}"
338,13,20,25.859593261664035,2,8,24,0.19528839445894708,"[8, 10, 6]",72.36927647647141,3.8942371679776744,20,night_charger,332,340,332,"{332: 72.36927647647141, 333: 68.47503930849373, 334: 56.79232780456071, 335: 37.32114196467234}"
338,12,22,45.625415238733396,5,11,24,0.10849355247719283,"[6, 7, 8]",94.48033333450726,4.955214100930605,22,night_charger,310,321,310,"{310: 94.48033333450726, 311: 89.52511923357666, 312: 74.65947693078485, 313: 49.88340642613182, 314: 15.196907719617585, 315: 0, 316: 0, 317: 0, 318: 0, 319: 0, 320: 0}"
338,11,20,27.60855761309042,2,9,24,0.22975105230464365,"[8, 0, 1]",50.742030788065016,4.652976903134535,20,night_charger,284,293,284,"{284: 50.742030788065016, 285: 46.08905388493048, 286: 32.130123175526876, 287: 8.8652386598542, 288: 0, 289: 0, 290: 0, 291: 0, 292: 0}"
339,12,19,28.796899040848736,2,4,23,0.16765291743323255,"[6, 5, 9]",100.55796518296253,2.2932365020435217,19,commuter,307,311,307,"{307: 100.55796518296253, 308: 98.264728680919, 309: 91.38501917478845, 310: 79.91883666457085}"
339,7,19,21.24455980714186,3,4,23,0.19723872639203832,"[4, 13, 11]",57.45735232499807,4.330663799308343,19,commuter,187,191,187,"{187: 57.45735232499807, 188: 53.12668852568973, 189: 40.134697127764696, 190: 18.481378131222982}"
339,2,18,41.43588689960891,4,6,24,0.19723872639203832,"[7, 8, 2]",85.94877338521198,1.2537982435064143,18,commuter,66,72,66,"{66: 85.94877338521198, 67: 84.69497514170557, 68: 80.93358041118633, 69: 74.66458919365425, 70: 65.88800148910934, 71: 54.60381729755162}"
340,4,18,83.07803025255677,5,6,24,0.16473192693137276,"[12, 14, 3]",134.57959326969643,3.662050330836657,18,commuter,114,120,114,"{114: 134.57959326969643, 115: 130.91754293885978, 116: 119.9313919463498, 117: 101.62114029216652, 118: 75.98678797630993, 119: 43.02833499878001}"
340,0,9,44.84496995946253,3,5,14,0.13727660577614395,"[7, 1, 6]",73.34932783097506,1.4021262031448765,9,commuter,9,14,9,"{9: 73.34932783097506, 10: 71.94720162783018, 11: 67.74082301839555, 12: 60.73019200267117, 13: 50.91530858065703}"
340,11,17,34.992681337481756,2,4,21,0.16473192693137276,"[1, 9, 10]",146.0886129224974,2.6197831231954463,17,commuter,281,285,281,"{281: 146.0886129224974, 282: 143.46882979930194, 283: 135.6094804297156, 284: 122.51056481373837}"
340,12,10,26.587020836794967,2,3,13,0.07779007660648159,"[1, 7, 6]",121.25442652865932,3.5826636448493785,10,commuter,298,301,298,"{298: 121.25442652865932, 299: 117.67176288380995, 300: 106.9237719492618}"
340,9,18,69.76102876036228,7,8,24,0.16473192693137276,"[8, 7, 5]",137.3899367501449,3.9972886863329387,18,commuter,234,242,234,"{234: 137.3899367501449, 235: 133.39264806381195, 236: 121.40078200481314, 237: 101.41433857314846, 238: 73.43331776881789, 239: 37.45771959182143, 240: 0, 241: 0}"
341,1,11,24.516425656731876,2,4,15,0.23137064263925466,"[11, 12, 3]",147.68614687965638,4.942049161553914,11,work_charger,35,39,35,"{35: 147.68614687965638, 36: 142.74409771810247, 37: 127.91795023344072, 38: 103.20770442567115}"
341,13,13,44.759120571207205,4,6,19,0.19666504624336648,"[6, 10, 3]",60.610485571540764,2.547758164135018,13,work_charger,325,331,325,"{325: 60.610485571540764, 326: 58.062727407405745, 327: 50.41945291500069, 328: 37.6806620943256, 329: 19.846354945380476, 330: 0}"
341,11,9,47.86470331967244,5,9,18,0.347055963958882,"[14, 1, 10]",127.63674617990559,4.151585252178892,9,work_charger,273,282,273,"{273: 127.63674617990559, 274: 123.4851609277267, 275: 111.03040517119001, 276: 90.27247891029556, 277: 61.211382145043316, 278: 23.84711487543329, 279: 0, 280: 0, 281: 0}"
342,7,19,33.097010158831324,2,3,22,0.14718082893917006,"[7, 0, 8]",90.93790817702308,4.091225629634625,19,commuter,187,190,187,"{187: 90.93790817702308, 188: 86.84668254738845, 189: 74.57300565848458}"
342,10,18,30.334151480258516,2,5,23,0.14718082893917006,"[13, 6, 3]",108.85518145706807,1.5478980038842587,18,commuter,258,263,258,"{258: 108.85518145706807, 259: 107.30728345318381, 260: 102.66358944153103, 261: 94.92409942210975, 262: 84.08881339491992}"
342,3,7,23.812625176292904,4,5,12,0.1226506907826417,"[14, 9, 11]",117.27907094660301,2.989746614092065,7,commuter,79,84,79,"{79: 117.27907094660301, 80: 114.28932433251094, 81: 105.32008449023475, 82: 90.37135141977443, 83: 69.44312512112998}"
342,3,7,21.422333530386112,2,5,12,0.1226506907826417,"[13, 5, 11]",101.53743307446751,3.1417959985897377,7,commuter,79,84,79,"{79: 101.53743307446751, 80: 98.39563707587777, 81: 88.97024908010856, 82: 73.26126908715987, 83: 51.26869709703171}"
342,1,18,46.05065289263632,3,4,22,0.14718082893917006,"[9, 13, 6]",73.29575268227728,4.468656386470707,18,commuter,42,46,42,"{42: 73.29575268227728, 43: 68.82709629580657, 44: 55.42112713639445, 45: 33.07784520404092}"
343,0,11,67.07429385061175,8,11,22,0.28931582437237496,"[6, 1, 11]",85.70353426088887,4.744346943650905,11,random,11,22,11,"{11: 85.70353426088887, 12: 80.95918731723796, 13: 66.72614648628524, 14: 43.00441176803073, 15: 9.79398316247439, 16: 0, 17: 0, 18: 0, 19: 0, 20: 0, 21: 0}"
344,1,7,38.493865085049976,4,5,12,0.21325427403843789,"[4, 14, 6]",97.18394638448609,2.9943921295880616,7,random,31,36,31,"{31: 97.18394638448609, 32: 94.18955425489803, 33: 85.20637786613385, 34: 70.23441721819354, 35: 49.27367231107711}"
344,10,16,81.56747442567965,7,8,24,0.14216951602562528,"[1, 5, 13]",84.46382205462983,3.8506457452548126,16,random,256,264,256,"{256: 84.46382205462983, 257: 80.61317630937502, 258: 69.06123907361058, 259: 49.80801034733652, 260: 22.853490130552828, 261: 0, 262: 0, 263: 0}"
344,4,11,68.43285562059108,6,7,18,0.14216951602562528,"[9, 2, 5]",147.12949119729376,2.4045512543826253,11,random,107,114,107,"{107: 147.12949119729376, 108: 144.72493994291113, 109: 137.51128617976326, 110: 125.48852990785014, 111: 108.65667112717176, 112: 87.01570983772812, 113: 60.56564603951925}"
345,3,19,43.075487408512366,5,7,24,0.49895545988242207,"[12, 1, 7]",122.99256078573147,3.087025750288459,19,commuter,91,98,91,"{91: 122.99256078573147, 92: 119.90553503544301, 93: 110.64445778457764, 94: 95.20932903313533, 95: 73.60014878111613, 96: 45.816917028519995, 97: 11.85963377534695}"
345,13,18,48.16671389076596,5,6,24,0.4241121409000587,"[8, 0, 3]",124.13004282766258,4.0126938869985,18,commuter,330,336,330,"{330: 124.13004282766258, 331: 120.11734894066407, 332: 108.07926727966858, 333: 88.01579784467609, 334: 59.92694063568658, 335: 23.81269565270007}"
345,6,18,46.63542333702235,6,7,24,0.4241121409000587,"[14, 13, 7]",112.3807263920875,2.5070709608176465,18,commuter,162,169,162,"{162: 112.3807263920875, 163: 109.87365543126985, 164: 102.35244254881691, 165: 89.81708774472868, 166: 72.26759101900515, 167: 49.70395237164634, 168: 22.126171802652223}"
346,13,10,52.0598366332277,6,9,19,0.11703031172447247,"[12, 3, 6]",62.49039053242029,2.6193285359409013,10,commuter,322,331,322,"{322: 62.49039053242029, 323: 59.87106199647939, 324: 52.013076388656685, 325: 38.916433708952184, 326: 20.58113395736587, 327: 0, 328: 0, 329: 0, 330: 0}"
346,6,18,36.98073876010437,3,6,24,0.2106545611040504,"[4, 8, 5]",133.02003306564782,3.1825645063742605,18,commuter,162,168,162,"{162: 133.02003306564782, 163: 129.83746855927356, 164: 120.28977504015079, 165: 104.37695250827949, 166: 82.09900096365965, 167: 53.45592040629131}"
346,7,18,92.8870467805013,5,8,24,0.24782889541652994,"[13, 1, 9]",141.98480247021956,2.148976940712782,18,commuter,186,194,186,"{186: 141.98480247021956, 187: 139.8358255295068, 188: 133.38889470736842, 189: 122.64401000380452, 190: 107.60117141881506, 191: 88.2603789524, 192: 64.62163260455941, 193: 36.68493237529324}"
346,6,16,38.47260834291879,2,4,20,0.11703031172447247,"[2, 7, 14]",69.51442698468864,1.1360661953841293,16,commuter,160,164,160,"{160: 69.51442698468864, 161: 68.37836078930451, 162: 64.97016220315213, 163: 59.28983122623148}"
346,2,8,24.031747694964523,3,6,14,0.2065240795137749,"[8, 2, 11]",60.9353933354973,2.6196708534752227,8,commuter,56,62,56,"{56: 60.9353933354973, 57: 58.31572248202208, 58: 50.45670992159641, 59: 37.3583556542203, 60: 19.02065967989374, 61: 0}"
347,3,8,37.84618082161785,4,7,15,0.17459199232281214,"[9, 6, 8]",104.39049674923837,1.7078118771994149,8,commuter,80,87,80,"{80: 104.39049674923837, 81: 102.68268487203895, 82: 97.5592492404407, 83: 89.02018985444363, 84: 77.06550671404773, 85: 61.69519981925299, 86: 42.90926917005943}"
347,6,16,32.677121498842865,3,6,22,0.09893546231626023,"[6, 5, 8]",95.25546619485678,1.1469875064942165,16,commuter,160,166,160,"{160: 95.25546619485678, 161: 94.10847868836257, 162: 90.66751616887991, 163: 84.93257863640883, 164: 76.90366609094932, 165: 66.58077853250137}"
347,6,11,38.73453727868099,3,6,17,0.09893546231626023,"[12, 13, 8]",118.48234920670627,1.0439936042818392,11,commuter,155,161,155,"{155: 118.48234920670627, 156: 117.43835560242444, 157: 114.30637478957891, 158: 109.08640676816972, 159: 101.77845153819685, 160: 92.3825090996603}"
347,8,17,30.3114559090939,5,6,23,0.2095103907873746,"[4, 10, 7]",66.21319452751702,3.3072791503650087,17,commuter,209,215,209,"{209: 66.21319452751702, 210: 62.90591537715201, 211: 52.98407792605698, 212: 36.44768217423194, 213: 13.296728121676878, 214: 0}"
347,0,9,25.626491827551316,2,5,14,0.17459199232281214,"[5, 3, 14]",132.15557004579924,3.5531024776805786,9,commuter,9,14,9,"{9: 132.15557004579924, 10: 128.60246756811867, 11: 117.94316013507692, 12: 100.17764774667403, 13: 75.30593040290998}"
348,2,12,28.710609940334113,4,7,19,0.11834113376164304,"[7, 14, 2]",102.77052921529724,1.0340855852863147,12,work_charger,60,67,60,"{60: 102.77052921529724, 61: 101.73644363001092, 62: 98.634186874152, 63: 93.46375894772041, 64: 86.22515985071621, 65: 76.91838958313937, 66: 65.54344814498992}"
348,12,18,36.758695122722045,3,6,24,0.18106193465531384,"[11, 10, 1]",100.20645820015676,4.123258524341182,18,work_charger,306,312,306,"{306: 100.20645820015676, 307: 96.08319967581558, 308: 83.71342410279203, 309: 63.09713148108612, 310: 34.23432181069785, 311: 0}"
348,1,13,28.097808797580797,2,6,19,0.11834113376164304,"[11, 9, 5]",122.09325483419113,4.129463180604638,13,work_charger,37,43,37,"{37: 122.09325483419113, 38: 117.9637916535865, 39: 105.57540211177258, 40: 84.92808620874939, 41: 56.02184394451692, 42: 18.85667531907518}"
348,1,10,45.89146918778749,3,6,16,0.11834113376164304,"[6, 1, 11]",131.36558200290594,1.5032753997532504,10,work_charger,34,40,34,"{34: 131.36558200290594, 35: 129.8623066031527, 36: 125.35248040389294, 37: 117.83610340512669, 38: 107.31317560685393, 39: 93.78369700907467}"
349,3,7,36.629821031450675,3,4,11,0.30062428820444614,"[12, 7, 9]",50.2750995553921,2.462802120780294,7,random,79,83,79,"{79: 50.2750995553921, 80: 47.81229743461181, 81: 40.423891072270926, 82: 28.109880468369454}"
350,1,18,42.81056555831414,5,7,24,0.18384721561919978,"[0, 1, 4]",131.6622366152305,2.8612513036312346,18,commuter,42,49,42,"{42: 131.6622366152305, 43: 128.80098531159928, 44: 120.21723140070557, 45: 105.9109748825494, 46: 85.88221575713075, 47: 60.13095402444965, 48: 28.657189684506065}"
350,5,11,17.711130538771705,1,4,15,0.08681674070906656,"[9, 14, 13]",103.6329825286106,4.961498091868848,11,commuter,131,135,131,"{131: 103.6329825286106, 132: 98.67148443674175, 133: 83.78699016113521, 134: 58.979499701790964}"
350,4,8,20.556634874347225,2,4,12,0.1532060130159998,"[8, 10, 3]",141.26791529118725,3.6176660954080484,8,commuter,104,108,104,"{104: 141.26791529118725, 105: 137.6502491957792, 106: 126.79725090955506, 107: 108.70892043251482}"
350,1,17,32.20566798907178,2,3,20,0.18384721561919978,"[4, 8, 3]",111.09517694362773,1.1633341814122535,17,commuter,41,44,41,"{41: 111.09517694362773, 42: 109.93184276221548, 43: 106.44184021797872}"
351,1,19,33.832860586810156,2,6,24,0.47604969666092006,"[4, 7, 6]",145.93351682839187,1.7012436420585586,19,random,43,49,43,"{43: 145.93351682839187, 44: 144.23227318633332, 45: 139.12854226015764, 46: 130.62232404986486, 47: 118.71361855545493, 48: 103.40242577692791}"
352,12,19,62.95745481717774,6,11,24,0.13969538965116543,"[6, 9, 7]",56.94478260544009,3.3833395876028898,19,night_charger,307,318,307,"{307: 56.94478260544009, 308: 53.5614430178372, 309: 43.41142425502853, 310: 26.49472631701408, 311: 2.811349203793853, 312: 0, 313: 0, 314: 0, 315: 0, 316: 0, 317: 0}"
352,1,21,58.994902112577414,6,12,24,0.0913041762425918,"[9, 4, 2]",93.01507529737574,4.485187932890289,21,night_charger,45,57,45,"{45: 93.01507529737574, 46: 88.52988736448546, 47: 75.07432356581458, 48: 52.64838390136314, 49: 21.252068371131116, 50: 0, 51: 0, 52: 0, 53: 0, 54: 0, 55: 0, 56: 0}"
353,3,18,49.82309782091037,3,4,22,0.1406274425968461,"[13, 6, 3]",51.497974747170176,1.2820912055951843,18,commuter,90,94,90,"{90: 51.497974747170176, 91: 50.21588354157499, 92: 46.36960992478944, 93: 39.95915389681352}"
353,11,9,65.98908809106798,8,11,20,0.11718953549737172,"[13, 8, 14]",50.56454505597669,1.5360732886564907,9,commuter,273,284,273,"{273: 50.56454505597669, 274: 49.0284717673202, 275: 44.420251901350724, 276: 36.73988545806827, 277: 25.987372437472835, 278: 12.16271283956442, 279: 0, 280: 0, 281: 0, 282: 0, 283: 0}"
353,6,18,43.04661366053762,3,4,22,0.11953332620731916,"[9, 6, 10]",68.08993720243662,2.831496208689728,18,commuter,162,166,162,"{162: 68.08993720243662, 163: 65.25844099374689, 164: 56.7639523676777, 165: 42.60647132422906}"
354,6,19,46.09534947410096,3,7,24,0.22730576275357878,"[4, 6, 14]",88.49137719139506,1.4139169066150923,19,random,163,170,163,"{163: 88.49137719139506, 164: 87.07746028477997, 165: 82.83570956493469, 166: 75.76612503185923, 167: 65.86870668555358, 168: 53.143454526017756, 169: 37.590368553251736}"
355,11,19,42.77281930949287,4,7,24,0.2116221186214667,"[5, 6, 7]",80.16841936744552,3.667689033863493,19,random,283,290,283,"{283: 80.16841936744552, 284: 76.50073033358203, 285: 65.49766323199155, 286: 47.159218062674086, 287: 21.485394825629633, 288: 0, 289: 0}"
355,7,19,52.84196178639602,4,5,24,0.2116221186214667,"[0, 1, 5]",65.48599975215818,1.3012801701782166,19,random,187,192,187,"{187: 65.48599975215818, 188: 64.18471958197996, 189: 60.28087907144531, 190: 53.77447822055423, 191: 44.66551702930671}"
356,5,15,45.40917861127509,3,8,23,0.11934118978457306,"[8, 7, 10]",101.58021016654791,4.975210106804784,15,weekend_user,135,143,135,"{135: 101.58021016654791, 136: 96.60500005974313, 137: 81.67936973932878, 138: 56.80331920530486, 139: 21.976848457671366, 140: 0, 141: 0, 142: 0}"
357,0,17,48.54164626976957,3,4,21,0.5293436916716734,"[3, 7, 2]",78.20930768156393,1.353194360430685,17,commuter,17,21,17,"{17: 78.20930768156393, 18: 76.85611332113324, 19: 72.79653023984119, 20: 66.03055843768776}"
357,3,8,72.32174004058234,4,6,14,0.44111974305972773,"[6, 11, 8]",112.6803630245473,3.017489972556609,8,commuter,80,86,80,"{80: 112.6803630245473, 81: 109.6628730519907, 82: 100.61040313432088, 83: 85.52295327153783, 84: 64.40052346364156, 85: 37.24311371063209}"
357,7,9,48.48466218077845,5,7,16,0.44111974305972773,"[2, 14, 5]",75.89176179313824,4.681050391979816,9,commuter,177,184,177,"{177: 75.89176179313824, 178: 71.21071140115843, 179: 57.16756022521898, 180: 33.7623082653199, 181: 0.9949555214611934, 182: 0, 183: 0}"
357,12,16,40.30234306757178,5,8,24,0.24996785440051242,"[0, 6, 12]",112.40437304168749,1.9560705868260362,16,commuter,304,312,304,"{304: 112.40437304168749, 305: 110.44830245486146, 306: 104.58009069438334, 307: 94.79973776025317, 308: 81.10724365247091, 309: 63.50260837103659, 310: 41.985831915950186, 311: 16.556914287211725}"
358,13,11,42.17790902683633,5,6,17,0.11818558658334834,"[6, 9, 13]",87.5375164840385,3.8389411115987406,11,commuter,323,329,323,"{323: 87.5375164840385, 324: 83.69857537243976, 325: 72.18175203764355, 326: 52.98704647964984, 327: 26.114458698458655, 328: 0}"
358,7,8,35.64732330838886,5,8,16,0.20856279985296763,"[14, 1, 3]",114.11531288601566,2.5959716666809887,8,commuter,176,184,176,"{176: 114.11531288601566, 177: 111.51934121933466, 178: 103.7314262192917, 179: 90.75156788588676, 180: 72.57976621911985, 181: 49.216021218990946, 182: 20.66033288550007, 183: 0}"
358,1,17,56.09756600321579,4,5,22,0.2502753598235612,"[10, 14, 1]",53.72226850893952,4.575434709972987,17,commuter,41,46,41,"{41: 53.72226850893952, 42: 49.14683379896653, 43: 35.420529669047575, 44: 12.54335611918264, 45: 0}"
358,8,19,21.996881769139158,2,5,24,0.2502753598235612,"[2, 5, 10]",148.1899054477998,4.188555360281569,19,commuter,211,216,211,"{211: 148.1899054477998, 212: 144.00135008751823, 213: 131.4356840066735, 214: 110.49290720526567, 215: 81.17301968329468}"
359,11,8,54.35536819602572,4,5,13,0.133326981920976,"[9, 14, 11]",125.99833692987511,2.545825656002295,8,commuter,272,277,272,"{272: 125.99833692987511, 273: 123.45251127387282, 274: 115.81503430586594, 275: 103.08590602585446, 276: 85.26512643383839}"
359,6,16,58.950264699639106,3,5,21,0.07555195642188642,"[0, 14, 1]",112.09274639669589,3.4786018006732635,16,commuter,160,165,160,"{160: 112.09274639669589, 161: 108.61414459602263, 162: 98.17833919400283, 163: 80.78533019063651, 164: 56.43511758592367}"
359,12,17,55.66479254147636,3,6,23,0.13599352155939554,"[4, 1, 14]",120.63602088376155,1.0483883499656041,17,commuter,305,311,305,"{305: 120.63602088376155, 306: 119.58763253379594, 307: 116.44246748389912, 308: 111.2005257340711, 309: 103.86180728431188, 310: 94.42631213462144}"
360,12,22,64.19283588621767,3,8,24,0.09146451278075847,"[4, 8, 2]",75.303154353214,1.1685109478119808,22,night_charger,310,318,310,"{310: 75.303154353214, 311: 74.13464340540202, 312: 70.62911056196607, 313: 64.78655582290617, 314: 56.606979188222304, 315: 46.09038065791448, 316: 33.236760231982686, 317: 18.046117910426936}"
360,3,20,40.237918162492804,2,7,24,0.19368955647690028,"[5, 13, 11]",80.54375022948572,4.699221916766588,20,night_charger,92,99,92,"{92: 80.54375022948572, 93: 75.84452831271913, 94: 61.74686256241937, 95: 38.25075297858643, 96: 5.356199561220322, 97: 0, 98: 0}"
361,10,17,58.50439692772809,8,11,24,0.41418038786772293,"[10, 3, 4]",96.95807033518258,4.646292560550792,17,commuter,257,268,257,"{257: 96.95807033518258, 258: 92.31177777463179, 259: 78.37290009297942, 260: 55.141437290225454, 261: 22.617389366369906, 262: 0, 263: 0, 264: 0, 265: 0, 266: 0, 267: 0}"
361,10,19,53.361118206413586,4,5,24,0.41418038786772293,"[1, 6, 9]",56.60455373060069,1.5403782263812391,19,commuter,259,264,259,"{259: 56.60455373060069, 260: 55.064175504219456, 261: 50.443040825075734, 262: 42.74114969316954, 263: 31.958502108500866}"
361,10,7,41.47351110279642,3,5,12,0.3451503232231024,"[0, 10, 2]",50.644944296470086,1.6026179546425352,7,commuter,247,252,247,"{247: 50.644944296470086, 248: 49.042326341827554, 249: 44.23447247789994, 250: 36.22138270468727, 251: 25.003057022189523}"
361,3,17,65.63288203871788,6,8,24,0.41418038786772293,"[12, 6, 11]",71.21784551089078,3.953700404971533,17,commuter,89,97,89,"{89: 71.21784551089078, 90: 67.26414510591925, 91: 55.40304389100465, 92: 35.63454186614698, 93: 7.958639031346252, 94: 0, 95: 0, 96: 0}"
362,5,9,31.682792690668645,3,6,15,0.10800756909680333,"[6, 8, 13]",90.2122591549645,4.224591856132168,9,random,129,135,129,"{129: 90.2122591549645, 130: 85.98766729883233, 131: 73.31389173043583, 132: 52.19093244977499, 133: 22.61878945684981, 134: 0}"
363,5,19,54.84673215244354,4,8,24,0.1769975636288976,"[7, 11, 1]",99.77062513760845,2.3298849076935233,19,work_charger,139,147,139,"{139: 99.77062513760845, 140: 97.44074022991492, 141: 90.45108550683436, 142: 78.80166096836675, 143: 62.492466614512075, 144: 41.52350244527037, 145: 15.894768460641615, 146: 0}"
363,6,14,32.45291726342585,5,10,24,0.09833197979383201,"[10, 4, 8]",106.25228436045802,3.8005182498238113,14,work_charger,158,168,158,"{158: 106.25228436045802, 159: 102.45176611063421, 160: 91.05021136116278, 161: 72.04762011204372, 162: 45.44399236327704, 163: 11.239328114862744, 164: 0, 165: 0, 166: 0, 167: 0}"
363,7,8,53.73655576841894,6,10,18,0.17352702316558588,"[6, 3, 7]",82.39941959538055,4.456753450219343,8,work_charger,176,186,176,"{176: 82.39941959538055, 177: 77.94266614516121, 178: 64.57240579450318, 179: 42.288638543406464, 180: 11.091364391871068, 181: 0, 182: 0, 183: 0, 184: 0, 185: 0}"
364,8,20,46.499755573649324,6,12,24,0.1531840980558391,"[3, 14, 11]",54.92787500290896,3.815124020138659,20,night_charger,212,224,212,"{212: 54.92787500290896, 213: 51.1127509827703, 214: 39.667378922354324, 215: 20.59175882166103, 216: 0, 217: 0, 218: 0, 219: 0, 220: 0, 221: 0, 222: 0, 223: 0}"
364,12,22,36.885275696661765,2,9,24,0.07233693519303512,"[12, 4, 13]",113.67758550359673,2.754835605970103,22,night_charger,310,319,310,"{310: 113.67758550359673, 311: 110.92274989762663, 312: 102.65824307971631, 313: 88.8840650498658, 314: 69.60021580807509, 315: 44.80669535434416, 316: 14.503503688673021, 317: 0, 318: 0}"
365,1,19,40.83439118393995,2,5,24,0.19703250394063773,"[4, 14, 11]",110.52172840290416,4.687196916053331,19,random,43,48,43,"{43: 110.52172840290416, 44: 105.83453148685084, 45: 91.77294073869083, 46: 68.33695615842419, 47: 35.52657774605086}"
366,8,11,40.00578070873836,3,5,16,0.11197935195352081,"[9, 13, 2]",59.051989794921326,3.79838581127094,11,work_charger,203,208,203,"{203: 59.051989794921326, 204: 55.253603983650386, 205: 43.858446549837566, 206: 24.866517493482867, 207: 0}"
366,6,18,52.8381383641644,6,11,24,0.17132840848888684,"[1, 8, 3]",87.46338696028664,4.733767319039625,18,work_charger,162,173,162,"{162: 87.46338696028664, 163: 82.72961964124701, 164: 68.52831768412814, 165: 44.85948108893001, 166: 11.723109855652638, 167: 0, 168: 0, 169: 0, 170: 0, 171: 0, 172: 0}"
366,13,18,85.37587947348715,7,12,24,0.17132840848888684,"[12, 10, 3]",145.38339718749583,2.8032776458347035,18,work_charger,330,342,330,"{330: 145.38339718749583, 331: 142.58011954166113, 332: 134.170286604157, 333: 120.1538983749835, 334: 100.53095485414057, 335: 75.30145604162824}"
366,13,14,27.143219076160243,2,5,19,0.09518244916049269,"[6, 1, 11]",129.93251672586197,3.9016625231458053,14,work_charger,326,331,326,"{326: 129.93251672586197, 327: 126.03085420271617, 328: 114.32586663327875, 329: 94.81755401754972, 330: 67.50591635552908}"
367,1,19,74.9973795062318,6,10,24,0.4104037173346039,"[7, 13, 14]",82.83443446534447,1.8987779671214233,19,random,43,53,43,"{43: 82.83443446534447, 44: 80.93565649822305, 45: 75.23932259685878, 46: 65.74543276125166, 47: 52.4539869914017, 48: 35.36498528730889, 49: 14.478427648973238, 50: 0, 51: 0, 52: 0}"
367,0,18,48.06770596420751,5,9,24,0.4104037173346039,"[12, 0, 2]",103.7959631644099,1.990248267547062,18,random,18,27,18,"{18: 103.7959631644099, 19: 101.80571489686284, 20: 95.83497009422165, 21: 85.88372875648633, 22: 71.9519908836569, 23: 54.03975647573335, 24: 32.14702553271566, 25: 6.2737980546038585, 26: 0}"
368,8,9,48.206576679621115,3,7,16,0.2995847357283106,"[3, 6, 14]",137.68730434938226,2.5770841391371224,9,random,201,208,201,"{201: 137.68730434938226, 202: 135.11022021024513, 203: 127.37896779283378, 204: 114.49354709714817, 205: 96.4539581231883, 206: 73.2602008709542, 207: 44.91227534044586}"
368,6,17,31.461221510020035,4,7,24,0.3055764304428768,"[9, 3, 11]",120.27632608064906,3.1939457843836605,17,random,161,168,161,"{161: 120.27632608064906, 162: 117.0823802962654, 163: 107.50054294311441, 164: 91.53081402119611, 165: 69.17319353051049, 166: 40.42768147105754, 167: 5.294277842837275}"
368,2,19,34.78022858525666,3,5,24,0.35950168287397277,"[10, 4, 6]",121.17215917272375,3.4250642541294867,19,random,67,72,67,"{67: 121.17215917272375, 68: 117.74709491859427, 69: 107.4719021562058, 70: 90.34658088555837, 71: 66.37113110665197}"
369,2,17,39.999055671787886,3,6,23,0.13789314400072417,"[0, 5, 3]",83.62259729920993,3.343536520208436,17,commuter,65,71,65,"{65: 83.62259729920993, 66: 80.2790607790015, 67: 70.24845121837619, 68: 53.530768617334004, 69: 30.12601297587495, 70: 0.03418429399901868}"
369,2,8,20.84423971262766,2,4,12,0.11491095333393678,"[4, 2, 11]",54.62765105152491,1.6023219764136911,8,commuter,56,60,56,"{56: 54.62765105152491, 57: 53.025329075111216, 58: 48.21836314587014, 59: 40.20675326380169}"
369,11,17,14.63597073373111,1,2,19,0.13789314400072417,"[8, 13, 14]",111.06420666317776,3.451593747926072,17,commuter,281,283,281,"{281: 111.06420666317776, 282: 107.61261291525169}"
370,13,10,21.581286549897747,3,7,17,0.15129398719011677,"[14, 9, 8]",115.77574650262021,4.263356684710775,10,weekend_user,322,329,322,"{322: 115.77574650262021, 323: 111.51238981790944, 324: 98.72231976377711, 325: 77.40553634022324, 326: 47.56203954724781, 327: 9.191829384850834, 328: 0}"
370,12,17,40.05223446403873,3,6,23,0.27232917694221015,"[7, 4, 11]",100.10703207072771,3.635803388021787,17,weekend_user,305,311,305,"{305: 100.10703207072771, 306: 96.47122868270593, 307: 85.56381851864056, 308: 67.38480157853164, 309: 41.93417786237912, 310: 9.21194737018304}"
371,12,18,25.519279917280524,3,6,24,0.11672390767344297,"[9, 8, 2]",113.98435062778967,4.317970545940092,18,commuter,306,312,306,"{306: 113.98435062778967, 307: 109.66638008184958, 308: 96.7124684440293, 309: 75.12261571432884, 310: 44.89682189274819, 311: 6.035086979287371}"
371,6,19,23.969243021664404,2,4,23,0.11672390767344297,"[4, 2, 11]",110.20913664698274,3.2601093694272203,19,commuter,163,167,163,"{163: 110.20913664698274, 164: 106.94902727755552, 165: 97.16869916927386, 166: 80.86815232213776}"
371,4,18,38.31534933800778,3,5,23,0.13732224432169762,"[5, 4, 8]",127.35172522712942,3.697845133777494,18,commuter,114,119,114,"{114: 127.35172522712942, 115: 123.65388009335193, 116: 112.56034469201944, 117: 94.07111902313198, 118: 68.18620308668952}"
371,11,7,36.18630127687587,2,5,12,0.11443520360141468,"[13, 3, 5]",114.70700185389826,2.057630856223803,7,commuter,271,276,271,"{271: 114.70700185389826, 272: 112.64937099767445, 273: 106.47647842900305, 274: 96.18832414788403, 275: 81.7849081543174}"
372,3,19,42.684131700280616,3,4,23,0.2080333127322081,"[11, 4, 9]",51.307361960544725,2.900873369489716,19,commuter,91,95,91,"{91: 51.307361960544725, 92: 48.40648859105501, 93: 39.70386848258586, 94: 25.19950163513728}"
372,2,17,49.864131043664194,6,7,24,0.2080333127322081,"[12, 3, 9]",51.43673591833896,4.391850365156799,17,commuter,65,72,65,"{65: 51.43673591833896, 66: 47.04488555318216, 67: 33.869334457711766, 68: 11.910082631927772, 69: 0, 70: 0, 71: 0}"
372,11,9,39.977677650021846,3,4,13,0.1733610939435067,"[14, 9, 12]",62.8591741225446,2.243159708406922,9,commuter,273,277,273,"{273: 62.8591741225446, 274: 60.61601441413768, 275: 53.88653528891692, 276: 42.670736746882305}"
372,10,17,51.244323115381846,3,5,22,0.2080333127322081,"[6, 0, 14]",62.2196761829238,3.1712435825924374,17,commuter,257,262,257,"{257: 62.2196761829238, 258: 59.04843260033136, 259: 49.53470185255405, 260: 33.67848393959186, 261: 11.4797788614448}"
373,12,10,58.026535575648595,7,9,19,0.18118939439218143,"[13, 7, 5]",82.55179816312652,2.0702544923260295,10,commuter,298,307,298,"{298: 82.55179816312652, 299: 80.48154367080049, 300: 74.2707801938224, 301: 63.91950773219226, 302: 49.42772628591005, 303: 30.79543585497578, 304: 8.022636439389458, 305: 0, 306: 0}"
373,6,13,47.03616649295318,5,7,20,0.18118939439218143,"[7, 1, 10]",101.83582663019337,2.9854992318914166,13,commuter,157,164,157,"{157: 101.83582663019337, 158: 98.85032739830196, 159: 89.8938297026277, 160: 74.96633354317062, 161: 54.0678389199307, 162: 27.198345832907947, 163: 0}"
373,13,11,54.26144167652457,6,8,19,0.18118939439218143,"[13, 11, 2]",133.15362865093536,3.7287073347980204,11,commuter,323,331,323,"{323: 133.15362865093536, 324: 129.42492131613733, 325: 118.23879931174328, 326: 99.59526263775318, 327: 73.49431129416703, 328: 39.93594528098485, 329: 0, 330: 0}"
373,4,8,12.157512194730856,1,2,10,0.3197459901038496,"[1, 13, 5]",138.6464348183862,2.990480261298588,8,commuter,104,106,104,"{104: 138.6464348183862, 105: 135.65595455708763}"
373,12,14,40.010190577624336,3,5,19,0.18118939439218143,"[11, 7, 0]",56.59809031162132,3.5945494765531545,14,commuter,302,307,302,"{302: 56.59809031162132, 303: 53.003540835068165, 304: 42.2198924054087, 305: 24.247145022642933, 306: 0}"
374,12,20,26.070306703417433,3,8,24,0.3536464003484528,"[3, 2, 0]",77.29548676404711,2.7964417634610097,20,night_charger,308,316,308,"{308: 77.29548676404711, 309: 74.49904500058611, 310: 66.10971971020308, 311: 52.12751089289802, 312: 32.55241854867096, 313: 7.384442677521875, 314: 0, 315: 0}"
374,0,22,34.4236211380027,2,7,24,0.23114143813624366,"[11, 2, 6]",145.35739579058833,3.9428673884197507,22,night_charger,22,29,22,"{22: 145.35739579058833, 23: 141.41452840216857, 24: 129.58592623690933, 25: 109.87158929481058, 26: 82.27151757587231, 27: 46.78571108009456, 28: 3.4141698074772933}"
374,1,21,26.884079958023754,2,10,24,0.23114143813624366,"[9, 2, 4]",138.99288171885064,1.0758845859630068,21,night_charger,45,55,45,"{45: 138.99288171885064, 46: 137.91699713288764, 47: 134.6893433749986, 48: 129.3099204451836, 49: 121.77872834344254, 50: 112.09576706977546, 51: 100.2610366241824, 52: 86.27453700666331, 53: 70.1362682172182, 54: 51.84623025584709}"
375,10,19,30.42854877349214,5,7,24,0.3319824083610484,"[7, 2, 12]",86.66739714541998,4.047751100641578,19,commuter,259,266,259,"{259: 86.66739714541998, 260: 82.6196460447784, 261: 70.47639274285368, 262: 50.237637239645785, 263: 21.90337953515474, 264: 0, 265: 0}"
375,10,8,27.30092575899845,4,5,13,0.27665200696754033,"[9, 7, 3]",64.06163568822839,1.4929850890011624,8,commuter,248,253,248,"{248: 64.06163568822839, 249: 62.56865059922723, 250: 58.08969533222374, 251: 50.62476988721793, 252: 40.17387426420979}"
375,4,17,30.75657215786553,4,6,23,0.3319824083610484,"[3, 9, 12]",137.58740586004453,3.040419762614264,17,commuter,113,119,113,"{113: 137.58740586004453, 114: 134.54698609743025, 115: 125.42572680958747, 116: 110.22362799651614, 117: 88.9406896582163, 118: 61.576911794687916}"
376,10,7,32.849764419246426,3,6,13,0.1191449525915334,"[9, 14, 2]",108.79898582402608,4.277998331796073,7,commuter,247,253,247,"{247: 108.79898582402608, 248: 104.52098749223, 249: 91.68699249684178, 250: 70.29700083786142, 251: 40.351012515288915, 252: 1.8490275291242568}"
376,3,7,49.40576247693286,3,6,13,0.1191449525915334,"[9, 5, 2]",94.02791708407852,2.1231016290409728,7,commuter,79,85,79,"{79: 94.02791708407852, 80: 91.90481545503755, 81: 85.53551056791463, 82: 74.92000242270977, 83: 60.05829101942296, 84: 40.95037635805421}"
376,3,7,14.339863681398285,1,4,11,0.1191449525915334,"[3, 4, 14]",76.3151236734212,3.692711476642521,7,commuter,79,83,79,"{79: 76.3151236734212, 80: 72.62241219677868, 81: 61.54427776685111, 82: 43.08072038363851}"
377,10,7,13.141644713303329,2,4,11,0.20067331041937894,"[1, 11, 2]",147.9940238572446,3.438481135195524,7,commuter,247,251,247,"{247: 147.9940238572446, 248: 144.55554272204907, 249: 134.2400993164625, 250: 117.04769364048488}"
377,3,9,29.451307287517825,2,3,12,0.20067331041937894,"[2, 14, 12]",95.41255758520417,4.4836094865356975,9,commuter,81,84,81,"{81: 95.41255758520417, 82: 90.92894809866847, 83: 77.47811963906138}"
377,1,19,27.923259487259458,2,4,23,0.24080797250325475,"[13, 10, 11]",78.35100356516101,4.486542015691226,19,commuter,43,47,43,"{43: 78.35100356516101, 44: 73.86446154946978, 45: 60.404835502396104, 46: 37.97212542393997}"
377,7,18,20.219431413685875,2,5,23,0.24080797250325475,"[13, 12, 2]",54.90498882698878,4.350398270023081,18,commuter,186,191,186,"{186: 54.90498882698878, 187: 50.55459055696569, 188: 37.50339574689645, 189: 15.751404396781048, 190: 0}"
378,1,7,35.62396006214585,5,6,13,0.2058269326559283,"[2, 1, 0]",139.65906206254772,4.648993880025762,7,commuter,31,37,31,"{31: 139.65906206254772, 32: 135.01006818252196, 33: 121.06308654244467, 34: 97.81811714231586, 35: 65.27515998213552, 36: 23.434215061903657}"
378,13,12,32.929031104526615,3,6,18,0.11663526183835939,"[1, 11, 6]",113.36324372661133,1.7499173233276801,12,commuter,324,330,324,"{324: 113.36324372661133, 325: 111.61332640328365, 326: 106.36357443330061, 327: 97.61398781666222, 328: 85.36456655336845, 329: 69.61531064341932}"
378,8,7,39.26232762256965,2,5,12,0.2058269326559283,"[4, 6, 7]",114.00346239421309,4.868180215617454,7,commuter,199,204,199,"{199: 114.00346239421309, 200: 109.13528217859563, 201: 94.53074153174327, 202: 70.18984045365599, 203: 36.11257894433382}"
378,8,18,30.921312146429326,4,6,24,0.246992319187114,"[8, 13, 1]",146.2465533756426,2.277489304064916,18,commuter,210,216,210,"{210: 146.2465533756426, 211: 143.9690640715777, 212: 137.13659615938295, 213: 125.74914963905836, 214: 109.80672451060394, 215: 89.30932077401971}"
379,9,11,21.537853729564482,2,6,17,0.15466956836921836,"[9, 6, 14]",116.7660523127356,1.821625322399235,11,random,227,233,227,"{227: 116.7660523127356, 228: 114.94442699033637, 229: 109.47955102313865, 230: 100.37142441114248, 231: 87.62004715434784, 232: 71.22541925275473}"
380,0,22,32.23309603876223,2,10,24,0.2081619536403023,"[2, 11, 0]",134.04066555637144,4.768785355342919,22,night_charger,22,32,22,"{22: 134.04066555637144, 23: 129.27188020102852, 24: 114.96552413499975, 25: 91.12159735828516, 26: 57.740099870884734, 27: 14.821031672798469, 28: 0, 29: 0, 30: 0, 31: 0}"
380,11,19,48.333355554164,5,12,24,0.3746915165525441,"[7, 4, 12]",58.139205801795825,2.86502421697398,19,night_charger,283,295,283,"{283: 58.139205801795825, 284: 55.27418158482185, 285: 46.679108933899904, 286: 32.353987849030005, 287: 12.298818330212143, 288: 0, 289: 0, 290: 0, 291: 0, 292: 0, 293: 0, 294: 0}"
381,7,18,33.70224852000744,2,3,21,0.219195556307862,"[4, 8, 3]",113.95775598485181,1.4626508847354027,18,commuter,186,189,186,"{186: 113.95775598485181, 187: 112.49510510011642, 188: 108.1071524459102}"
381,12,18,25.445438193684417,2,5,23,0.18631622286168267,"[14, 8, 13]",84.64997710168477,4.443366412389903,18,commuter,306,311,306,"{306: 84.64997710168477, 307: 80.20661068929486, 308: 66.87651145212516, 309: 44.65967939017564, 310: 13.556114503446324}"
381,1,19,41.06108408312566,4,5,24,0.219195556307862,"[12, 11, 3]",98.37919061297177,2.807252313643682,19,commuter,43,48,43,"{43: 98.37919061297177, 44: 95.57193829932808, 45: 87.15018135839703, 46: 73.11391979017863, 47: 53.46315359467285}"
381,2,8,23.867964659013627,3,4,12,0.18266296358988499,"[6, 8, 4]",67.522751301703,4.073924917149224,8,commuter,56,60,56,"{56: 67.522751301703, 57: 63.44882638455377, 58: 51.2270516331061, 59: 30.857427047359977}"
381,6,14,36.93294075647592,3,4,18,0.10350901270093484,"[12, 4, 6]",147.53808739674116,4.064545184056611,14,commuter,158,162,158,"{158: 147.53808739674116, 159: 143.47354221268455, 160: 131.2799066605147, 161: 110.95718074023166}"
382,3,7,38.56574205508279,3,4,11,0.3237076239644293,"[9, 8, 11]",89.84588908198259,1.1046245781296524,7,random,79,83,79,"{79: 89.84588908198259, 80: 88.74126450385293, 81: 85.42739076946398, 82: 79.90426787881572}"
382,4,20,44.003565304592,3,6,24,0.38844914875731523,"[5, 14, 7]",60.32761655319003,2.0425060533483026,20,random,116,122,116,"{116: 60.32761655319003, 117: 58.28511049984173, 118: 52.15759233979682, 119: 41.94506207305531, 120: 27.64751969961719, 121: 9.26496521948247}"
382,8,12,14.39838989786055,1,4,16,0.2158050826429529,"[0, 13, 12]",56.32540308742924,2.459470437281645,12,random,204,208,204,"{204: 56.32540308742924, 205: 53.86593265014759, 206: 46.487521338302656, 207: 34.19016915189443}"
383,10,20,50.728010791079654,3,8,24,0.1540023188161555,"[5, 9, 14]",149.75025034811972,4.098859912044764,20,night_charger,260,268,260,"{260: 149.75025034811972, 261: 145.65139043607496, 262: 133.35481069994066, 263: 112.86051113971683, 264: 84.1684917554035, 265: 47.27875254700062, 266: 2.191293514508203, 267: 0}"
383,3,20,21.71580156642047,2,7,24,0.1540023188161555,"[6, 0, 7]",148.39282017016177,3.0922436358922076,20,night_charger,92,99,92,"{92: 148.39282017016177, 93: 145.30057653426957, 94: 136.02384562659293, 95: 120.5626274471319, 96: 98.91692199588644, 97: 71.08672927285657, 98: 37.0720492780423}"
384,5,18,81.61645491993946,7,8,24,0.21741282951271262,"[6, 4, 11]",75.23616817455196,4.644102948626463,18,commuter,138,146,138,"{138: 75.23616817455196, 139: 70.5920652259255, 140: 56.65975638004611, 141: 33.4392416369138, 142: 0.930520996528557, 143: 0, 144: 0, 145: 0}"
384,13,13,48.16732939539753,3,4,17,0.12078490528484036,"[2, 4, 12]",140.37489307433913,3.156032950241199,13,commuter,325,329,325,"{325: 140.37489307433913, 326: 137.21886012409792, 327: 127.75076127337434, 328: 111.97059652216834}"
384,5,11,68.40852595438214,4,5,16,0.12078490528484036,"[6, 9, 7]",138.68098656594017,1.6443369876684462,11,commuter,131,136,131,"{131: 138.68098656594017, 132: 137.03664957827172, 133: 132.1036386152664, 134: 123.88195367692416, 135: 112.37159476324504}"
385,4,18,60.94468494535745,5,7,24,0.25418813751486086,"[0, 9, 8]",59.7035778509925,3.380039110073604,18,commuter,114,121,114,"{114: 59.7035778509925, 115: 56.3235387409189, 116: 46.18342141069809, 117: 29.283225860330067, 118: 5.622952089814838, 119: 0, 120: 0}"
385,11,17,29.63456843712492,2,3,20,0.25418813751486086,"[11, 5, 6]",73.4160740101667,4.95659964266669,17,commuter,281,284,281,"{281: 73.4160740101667, 282: 68.45947436750001, 283: 53.589675439499935}"
385,11,17,28.101480155592228,2,5,22,0.25418813751486086,"[9, 0, 7]",132.76273793621448,1.8887567048332028,17,commuter,281,286,281,"{281: 132.76273793621448, 282: 130.87398123138126, 283: 125.20771111688167, 284: 115.76392759271565, 285: 102.54263065888324}"
385,4,7,22.453650190361405,2,3,10,0.21182344792905067,"[12, 6, 9]",55.880453388830475,3.1178594078858666,7,commuter,103,106,103,"{103: 55.880453388830475, 104: 52.76259398094461, 105: 43.40901575728701}"
385,13,14,43.54576008986266,4,5,19,0.12003328715979539,"[13, 5, 9]",77.81739198753237,1.7233013246094955,14,commuter,326,331,326,"{326: 77.81739198753237, 327: 76.09409066292288, 328: 70.9241866890944, 329: 62.30768006604691, 330: 50.24457079378045}"
386,13,20,44.222258073717065,3,6,24,0.1895112903342637,"[13, 7, 14]",100.9228813848111,1.4634081532054704,20,weekend_user,332,338,332,"{332: 100.9228813848111, 333: 99.45947323160564, 334: 95.06924877198922, 335: 87.75220800596188}"
387,0,18,35.82828749815704,2,6,24,0.2315228535378613,"[1, 7, 11]",129.03682248650875,4.849521308908156,18,random,18,24,18,"{18: 129.03682248650875, 19: 124.1873011776006, 20: 109.63873725087613, 21: 85.39113070633535, 22: 51.444481543978256, 23: 7.798789763804848}"
388,5,10,20.77802645538872,2,3,13,0.06399680497146044,"[14, 5, 2]",101.33387070264081,1.135062308881861,10,commuter,130,133,130,"{130: 101.33387070264081, 131: 100.19880839375895, 132: 96.79362146711337}"
388,9,9,45.628423500881425,6,8,17,0.11293553818493018,"[14, 0, 11]",100.61051489073336,2.845622535354067,9,commuter,225,233,225,"{225: 100.61051489073336, 226: 97.76489235537929, 227: 89.22802474931709, 228: 74.99991207254675, 229: 55.080554325068285, 230: 29.469951506881685, 231: 0, 232: 0}"
388,6,19,24.792499336774014,2,4,23,0.1151942489486288,"[2, 3, 7]",143.02998154333,3.2955263630610303,19,commuter,163,167,163,"{163: 143.02998154333, 164: 139.73445518026895, 165: 129.84787609108588, 166: 113.37024427578072}"
389,12,9,51.4188710528583,4,8,17,0.14509833011118142,"[1, 13, 9]",134.46064826173756,4.824178749512164,9,random,297,305,297,"{297: 134.46064826173756, 298: 129.6364695122254, 299: 115.1639332636889, 300: 91.04303951612809, 301: 57.27378826954293, 302: 13.856179523933463, 303: 0, 304: 0}"
389,12,21,44.582918646663735,6,7,24,0.09673222007412095,"[12, 1, 4]",147.51633799147686,1.8534806286211776,21,random,309,316,309,"{309: 147.51633799147686, 310: 145.66285736285568, 311: 140.10241547699215, 312: 130.83501233388625, 313: 117.86064793353802, 314: 101.17932227594741, 315: 80.79103536111447}"
389,0,21,60.87953213309888,5,7,24,0.113802611851907,"[3, 8, 1]",124.67498825153476,4.38982407425341,21,random,21,28,21,"{21: 124.67498825153476, 22: 120.28516417728135, 23: 107.11569195452111, 24: 85.16657158325407, 25: 54.4378030634802, 26: 14.929386395199515, 27: 0}"
390,5,11,23.87638539153664,2,5,16,0.20164397384399782,"[11, 6, 2]",63.81553899525346,2.489516753564443,11,commuter,131,136,131,"{131: 63.81553899525346, 132: 61.32602224168902, 133: 53.85747198099569, 134: 41.409888213173474, 135: 23.983270938222375}"
390,7,7,41.27551925897326,3,4,11,0.3558423067835255,"[11, 10, 3]",66.2145003568245,3.188732328271763,7,commuter,175,179,175,"{175: 66.2145003568245, 176: 63.02576802855274, 177: 53.45957104373745, 178: 37.51590940237864}"
390,1,9,18.432505543614273,1,2,11,0.3558423067835255,"[14, 7, 12]",141.70515920403795,3.733301730143539,9,commuter,33,35,33,"{33: 141.70515920403795, 34: 137.9718574738944}"
390,0,9,33.01581564388157,4,5,14,0.3558423067835255,"[4, 7, 12]",142.70794050436362,2.9499045786137663,9,commuter,9,14,9,"{9: 142.70794050436362, 10: 139.75803592574985, 11: 130.90832218990855, 12: 116.15879929683973, 13: 95.50946724654335}"
390,13,10,28.51826587711076,3,6,16,0.20164397384399782,"[13, 6, 7]",120.24971168239118,3.651983585595603,10,commuter,322,328,322,"{322: 120.24971168239118, 323: 116.59772809679558, 324: 105.64177734000877, 325: 87.38185941203075, 326: 61.81797431286153, 327: 28.950122042501107}"
391,6,10,50.3281229594714,6,8,18,0.09040527008280637,"[11, 7, 12]",50.65163156918753,2.908199750867529,10,random,154,162,154,"{154: 50.65163156918753, 155: 47.74343181832, 156: 39.01883256571742, 157: 24.47783381137977, 158: 4.120435555307068, 159: 0, 160: 0, 161: 0}"
391,3,17,34.79146708128751,3,6,23,0.19144645429300172,"[7, 8, 14]",95.8451060949163,3.0141938919050313,17,random,89,95,89,"{89: 95.8451060949163, 90: 92.83091220301127, 91: 83.78833052729618, 92: 68.71736106777102, 93: 47.6180038244358, 94: 20.490258797290522}"
391,6,15,40.59712032473934,3,4,19,0.09040527008280637,"[8, 12, 7]",146.00582757647734,2.0871750104946996,15,random,159,163,159,"{159: 146.00582757647734, 160: 143.91865256598265, 161: 137.65712753449856, 162: 127.22125248202505}"
392,8,17,38.50821827027155,3,6,23,0.37119706579724915,"[4, 1, 8]",102.87946118037488,4.188671088901495,17,commuter,209,215,209,"{209: 102.87946118037488, 210: 98.69079009147337, 211: 86.1247768247689, 212: 65.18142138026141, 213: 35.86072375795095, 214: 0}"
392,8,8,48.43652936413121,6,7,15,0.3093308881643742,"[6, 1, 8]",147.70518594542352,4.89725474802114,8,commuter,200,207,200,"{200: 147.70518594542352, 201: 142.80793119740238, 202: 128.11616695333896, 203: 103.62989321323326, 204: 69.34910997708528, 205: 25.273817244895014, 206: 0}"
392,4,18,73.45546267021021,6,9,24,0.37119706579724915,"[13, 1, 11]",73.3570898046737,2.8737197619810027,18,commuter,114,123,114,"{114: 73.3570898046737, 115: 70.4833700426927, 116: 61.8622107567497, 117: 47.49361194684468, 118: 27.377573612977663, 119: 1.5140957551486451, 120: 0, 121: 0, 122: 0}"
392,10,18,11.157079291522592,1,2,20,0.37119706579724915,"[8, 6, 5]",72.3279126932402,3.7447660019384084,18,commuter,258,260,258,"{258: 72.3279126932402, 259: 68.58314669130179}"
392,1,8,20.487963898303413,2,3,11,0.3093308881643742,"[1, 9, 13]",79.99634508814911,3.316562002853757,8,commuter,32,35,32,"{32: 79.99634508814911, 33: 76.67978308529536, 34: 66.73009707673408}"
393,0,9,32.563719735774214,3,6,15,0.4117813634150341,"[9, 14, 0]",92.30873698539042,1.417456398177579,9,commuter,9,15,9,"{9: 92.30873698539042, 10: 90.89128058721285, 11: 86.63891139268011, 12: 79.55162940179221, 13: 69.62943461454915, 14: 56.87232703095095}"
393,11,7,19.05977604154663,2,3,10,0.4117813634150341,"[14, 7, 5]",128.9262996991285,2.6993567924370816,7,commuter,271,274,271,"{271: 128.9262996991285, 272: 126.2269429066914, 273: 118.12887252938016}"
393,8,19,69.73117246454927,5,6,24,0.494137636098041,"[11, 2, 8]",88.52507183619218,2.8388438737934747,19,commuter,211,217,211,"{211: 88.52507183619218, 212: 85.6862279623987, 213: 77.16969634101828, 214: 62.97547697205091, 215: 43.10356985549659, 216: 17.553974991355318}"
393,10,9,71.12903638207264,4,7,16,0.4117813634150341,"[7, 9, 1]",87.1627618438402,4.720957964172214,9,commuter,249,256,249,"{249: 87.1627618438402, 250: 82.44180387966799, 251: 68.27892998715134, 252: 44.67414016629027, 253: 11.627434417084771, 254: 0, 255: 0}"
394,2,17,25.95684423610116,2,4,21,0.138028819491597,"[11, 8, 4]",52.39894074795208,3.2365530753590086,17,commuter,65,69,65,"{65: 52.39894074795208, 66: 49.16238767259307, 67: 39.45272844651605, 68: 23.269963069721005}"
394,8,19,24.379029739146212,2,3,22,0.138028819491597,"[12, 3, 7]",87.57007744220836,2.399405548121571,19,commuter,211,214,211,"{211: 87.57007744220836, 212: 85.17067189408678, 213: 77.97245524972207}"
394,2,18,32.81362046113846,3,6,24,0.138028819491597,"[12, 14, 7]",79.0950425552129,3.4059718118997653,18,commuter,66,72,66,"{66: 79.0950425552129, 67: 75.68907074331314, 68: 65.47115530761384, 69: 48.44129624811501, 70: 24.599493564816655, 71: 0}"
394,13,11,33.091003652082506,3,4,15,0.06518027587103191,"[11, 14, 3]",149.73824938253694,2.568626620964915,11,commuter,323,327,323,"{323: 149.73824938253694, 324: 147.16962276157201, 325: 139.46374289867728, 326: 126.62060979385271}"
395,12,15,22.33132506938164,3,7,22,0.07679296497854082,"[4, 13, 7]",65.49296868447233,3.1431865847477765,15,weekend_user,303,310,303,"{303: 65.49296868447233, 304: 62.34978209972456, 305: 52.92022234548122, 306: 37.204289421742345, 307: 15.201983328507907, 308: 0, 309: 0}"
395,6,11,40.63884445836384,4,7,18,0.07679296497854082,"[8, 10, 2]",142.99828176615765,2.314660524421781,11,weekend_user,155,162,155,"{155: 142.99828176615765, 156: 140.68362124173586, 157: 133.73963966847052, 158: 122.16633704636162, 159: 105.96371337540916, 160: 85.13176865561312, 161: 59.67050288697352}"
396,12,20,13.919161399283439,1,6,24,0.11648779470615273,"[13, 4, 0]",129.36712853056488,2.742660082806531,20,night_charger,308,314,308,"{308: 129.36712853056488, 309: 126.62446844775835, 310: 118.39648819933876, 311: 104.6831877853061, 312: 85.4845672056604, 313: 60.80062646040162}"
396,12,23,42.4890016558857,4,10,24,0.045300809052392726,"[4, 10, 2]",88.73584897079607,3.500214291881466,23,night_charger,311,321,311,"{311: 88.73584897079607, 312: 85.23563467891461, 313: 74.7349918032702, 314: 57.23392034386288, 315: 32.73242030069262, 316: 1.2304916737594311, 317: 0, 318: 0, 319: 0, 320: 0}"
396,13,19,43.118831668838254,3,9,24,0.11648779470615273,"[10, 1, 6]",77.85851728470656,3.312160446515201,19,night_charger,331,340,331,"{331: 77.85851728470656, 332: 74.54635683819136, 333: 64.60987549864576, 334: 48.049073266069755, 335: 24.863950140463352}"
397,4,17,29.915022381351825,2,4,21,0.22189026853038418,"[8, 14, 1]",69.68671510108072,3.8229709847900155,17,commuter,113,117,113,"{113: 69.68671510108072, 114: 65.8637441162907, 115: 54.39483116192066, 116: 35.27997623797058}"
397,4,17,30.86985091245939,3,6,23,0.22189026853038418,"[0, 13, 7]",73.04975175664131,3.033650798109381,17,commuter,113,119,113,"{113: 73.04975175664131, 114: 70.01610095853194, 115: 60.91514856420379, 116: 45.74689457365689, 117: 24.511338986891218, 118: 0}"
397,7,19,24.253952353131623,2,3,22,0.22189026853038418,"[3, 10, 13]",141.19685798632258,4.172958799362274,19,commuter,187,190,187,"{187: 141.19685798632258, 188: 137.0238991869603, 189: 124.50502278887349}"
397,12,11,44.54652050035741,3,4,15,0.10478151569490364,"[12, 2, 9]",132.11421268986794,4.446361411089997,11,commuter,299,303,299,"{299: 132.11421268986794, 300: 127.66785127877795, 301: 114.32876704550796, 302: 92.09695999005797}"
398,2,7,52.88049038614578,4,5,12,0.17329203224633338,"[9, 1, 8]",54.99619646718399,2.1546081932518635,7,commuter,55,60,55,"{55: 54.99619646718399, 56: 52.84158827393213, 57: 46.37776369417654, 58: 35.60472272791722, 59: 20.522465375154177}"
398,0,8,50.46276452386471,3,4,12,0.17329203224633338,"[10, 12, 6]",62.45154688336204,4.759933141563305,8,commuter,8,12,8,"{8: 62.45154688336204, 9: 57.69161374179873, 10: 43.41181431710882, 11: 19.61214860929229}"
398,10,7,33.98547983982047,3,4,11,0.17329203224633338,"[9, 4, 14]",118.0817089953536,2.633746707568226,7,commuter,247,251,247,"{247: 118.0817089953536, 248: 115.44796228778537, 249: 107.5467221650807, 250: 94.37798862723956}"
399,8,21,18.89700684041104,1,6,24,0.19933410876097427,"[12, 11, 13]",88.72295796229693,1.4586528245678414,21,night_charger,213,219,213,"{213: 88.72295796229693, 214: 87.2643051377291, 215: 82.88834666402556, 216: 75.59508254118636, 217: 65.38451276921147, 218: 52.256637348100895}"
399,3,21,42.69858712264891,3,8,24,0.19933410876097427,"[11, 6, 12]",114.62821454094252,1.713494653908116,21,night_charger,93,101,93,"{93: 114.62821454094252, 94: 112.91471988703441, 95: 107.77423592531005, 96: 99.20676265576948, 97: 87.21230007841267, 98: 71.79084819323963, 99: 52.94240700025035, 100: 30.666976499444843}"
399,7,21,31.911805243272724,4,10,24,0.19933410876097427,"[6, 13, 1]",147.47369472575073,3.5927182330614937,21,night_charger,189,199,189,"{189: 147.47369472575073, 190: 143.88097649268923, 191: 133.10282179350475, 192: 115.13923062819728, 193: 89.99020299676684, 194: 57.65573889921339, 195: 18.13583833553696, 196: 0, 197: 0, 198: 0}"
400,8,7,30.50700893601431,2,5,12,0.25851337985935774,"[2, 9, 5]",115.24581484879536,1.8195489147671018,7,commuter,199,204,199,"{199: 115.24581484879536, 200: 113.42626593402827, 201: 107.96761918972696, 202: 98.86987461589145, 203: 86.13303221252173}"
400,13,10,69.62723296595917,5,7,17,0.14649091525363606,"[1, 5, 9]",133.291827812863,1.0584961720400696,10,commuter,322,329,322,"{322: 133.291827812863, 323: 132.23333164082294, 324: 129.0578431247027, 325: 123.76536226450239, 326: 116.3558890602219, 327: 106.82942351186126, 328: 95.1859656194205}"
400,8,9,36.40147649622037,2,3,12,0.25851337985935774,"[14, 13, 1]",141.4475106009005,4.513779651804318,9,commuter,201,204,201,"{201: 141.4475106009005, 202: 136.93373094909617, 203: 123.39239199368323}"
401,13,14,52.590519691384564,5,7,21,0.07253286613742671,"[1, 14, 3]",65.85470867493491,4.36257177909285,14,commuter,326,333,326,"{326: 65.85470867493491, 327: 61.492136895842066, 328: 48.40442155856351, 329: 26.591562663099268, 330: 0, 331: 0, 332: 0}"
401,8,7,25.98997555350144,2,3,10,0.12799917553663537,"[11, 2, 7]",63.140537180546374,4.950796771044331,7,commuter,199,202,199,"{199: 63.140537180546374, 200: 58.18974040950204, 201: 43.33735009636905}"
401,13,19,46.302898020474736,3,5,24,0.13055915904736806,"[3, 11, 1]",98.28914559942768,2.9362124766088287,19,commuter,331,336,331,"{331: 98.28914559942768, 332: 95.35293312281885, 333: 86.54429569299236, 334: 71.86323330994823, 335: 51.309745973686425}"
402,5,9,61.37112925956352,8,12,21,0.18491151602036873,"[3, 2, 6]",118.08872600004301,3.9686514510830233,9,weekend_user,129,141,129,"{129: 118.08872600004301, 130: 114.12007454895999, 131: 102.21412019571092, 132: 82.37086294029581, 133: 54.59030278271464, 134: 18.872439722967428, 135: 0, 136: 0, 137: 0, 138: 0, 139: 0, 140: 0}"
403,12,10,41.33359141811618,4,5,15,0.07326649487623957,"[14, 12, 13]",88.71857126111459,1.7888079954041332,10,commuter,298,303,298,"{298: 88.71857126111459, 299: 86.92976326571046, 300: 81.56333927949805, 301: 72.61929930247739, 302: 60.09764333464846}"
403,0,17,56.024486359343754,8,11,24,0.15515257738497792,"[3, 7, 13]",69.34245110426926,1.96753859193115,17,commuter,17,28,17,"{17: 69.34245110426926, 18: 67.37491251233811, 19: 61.472296736544656, 20: 51.63460377688891, 21: 37.86183363337086, 22: 20.153986305990507, 23: 0, 24: 0, 25: 0, 26: 0, 27: 0}"
403,0,8,37.541400980910375,4,5,13,0.12929381448748156,"[8, 3, 4]",74.51321648345136,3.6006892542900433,8,commuter,8,13,8,"{8: 74.51321648345136, 9: 70.91252722916131, 10: 60.11045946629119, 11: 42.10701319484097, 12: 16.902188414810666}"
403,4,8,36.545764080026494,2,3,11,0.12929381448748156,"[7, 13, 8]",94.66677244614155,3.663402437971979,8,commuter,104,107,104,"{104: 94.66677244614155, 105: 91.00337000816957, 106: 80.01316269425364}"
403,2,19,40.443370886051724,4,5,24,0.15515257738497792,"[14, 8, 10]",117.79284224614184,4.282803345144254,19,commuter,67,72,67,"{67: 117.79284224614184, 68: 113.51003890099759, 69: 100.66162886556484, 70: 79.24761213984357, 71: 49.26798872383378}"
404,5,21,25.70036568960885,2,8,24,0.08154673568518671,"[8, 0, 4]",55.318534146714946,4.600619005790621,21,night_charger,141,149,141,"{141: 55.318534146714946, 142: 50.717915140924326, 143: 36.91605812355246, 144: 13.912963094599355, 145: 0, 146: 0, 147: 0, 148: 0}"
404,8,19,40.67533330398094,3,10,24,0.17268720498039541,"[4, 12, 1]",106.89958347036713,2.0932688920564027,19,night_charger,211,221,211,"{211: 106.89958347036713, 212: 104.80631457831073, 213: 98.52650790214152, 214: 88.06016344185952, 215: 73.4072811974647, 216: 54.567861168957066, 217: 31.541903356336633, 218: 4.329407759603399, 219: 0, 220: 0}"
405,12,11,37.4065718163275,4,9,20,0.16650203904711244,"[13, 12, 5]",88.58202888740259,3.806013830749962,11,weekend_user,299,308,299,"{299: 88.58202888740259, 300: 84.77601505665262, 301: 73.35797356440274, 302: 54.32790441065293, 303: 27.685807595403197, 304: 0, 305: 0, 306: 0, 307: 0}"
406,7,9,51.69730307024102,3,6,15,0.1784058298476694,"[10, 0, 3]",142.99306628757037,3.6543104936348523,9,commuter,177,183,177,"{177: 142.99306628757037, 178: 139.33875579393552, 179: 128.37582431303096, 180: 110.1042718448567, 181: 84.52409838941273, 182: 51.63530394669907}"
406,2,8,57.63721209307865,4,5,13,0.1784058298476694,"[11, 13, 9]",131.5904586381457,2.249142303557021,8,commuter,56,61,56,"{56: 131.5904586381457, 57: 129.34131633458867, 58: 122.5938894239176, 59: 111.3481779061325, 60: 95.60418178123336}"
406,3,8,33.689887554400336,2,5,13,0.1784058298476694,"[2, 11, 10]",149.29081920521133,3.515239207176431,8,commuter,80,85,80,"{80: 149.29081920521133, 81: 145.7755799980349, 82: 135.22986237650562, 83: 117.65366634062346, 84: 93.04699189038844}"
406,11,8,60.01894934199112,3,5,13,0.1784058298476694,"[11, 10, 4]",119.85779287251651,4.547054580167805,8,commuter,272,277,272,"{272: 119.85779287251651, 273: 115.3107382923487, 274: 101.6695745518453, 275: 78.93430165100628, 276: 47.10491958983164}"
406,4,7,48.355735628783265,4,7,14,0.1784058298476694,"[4, 12, 11]",75.4183066044395,4.763858457385469,7,commuter,103,110,103,"{103: 75.4183066044395, 104: 70.65444814705403, 105: 56.36287277489762, 106: 32.543580487970274, 107: 0, 108: 0, 109: 0}"
407,11,7,36.02881477268998,3,5,12,0.14840895877601024,"[7, 14, 13]",97.9686754620486,4.517074504345872,7,commuter,271,276,271,"{271: 97.9686754620486, 272: 93.45160095770272, 273: 79.90037744466511, 274: 57.31500492293575, 275: 25.695483392514646}"
407,13,19,25.282171342912253,2,4,23,0.15137713795153046,"[11, 10, 12]",56.849707476267895,1.840421798020086,19,commuter,331,335,331,"{331: 56.849707476267895, 332: 55.00928567824781, 333: 49.48802028418755, 334: 40.28591129408712}"
407,0,8,39.947512435072966,3,5,13,0.14840895877601024,"[13, 7, 8]",149.1304059411111,3.1273803334367165,8,commuter,8,13,8,"{8: 149.1304059411111, 9: 146.00302560767437, 10: 136.62088460736422, 11: 120.98398294018065, 12: 99.09232060612362}"
407,7,7,52.92557238362399,4,7,14,0.14840895877601024,"[8, 13, 12]",139.1927478126056,4.761667170530105,7,commuter,175,182,175,"{175: 139.1927478126056, 176: 134.4310806420755, 177: 120.14607913048519, 178: 96.33774327783466, 179: 63.006073084123926, 180: 20.151068549352985, 181: 0}"
407,12,14,20.986972604215147,2,5,19,0.08409840997307248,"[7, 9, 12]",146.08761351199334,4.491551399841263,14,commuter,302,307,302,"{302: 146.08761351199334, 303: 141.59606211215208, 304: 128.12140791262829, 305: 105.66365091342198, 306: 74.22279111453314}"
408,12,13,33.616468746668225,2,4,17,0.14955032465807483,"[0, 1, 13]",134.87193289276144,2.9446578629935876,13,commuter,301,305,301,"{301: 134.87193289276144, 302: 131.92727502976786, 303: 123.09330144078709, 304: 108.37001212581914}"
408,13,13,15.253649411475909,2,5,18,0.14955032465807483,"[14, 7, 9]",77.88201362466967,2.287187634350435,13,commuter,325,330,325,"{325: 77.88201362466967, 326: 75.59482599031924, 327: 68.73326308726793, 328: 57.29732491551575, 329: 41.287011475062705}"
408,1,7,60.46452285448869,4,5,12,0.26391233763189675,"[11, 4, 5]",77.43501638553697,2.6944876708850787,7,commuter,31,36,31,"{31: 77.43501638553697, 32: 74.74052871465189, 33: 66.65706570199666, 34: 53.184627347571265, 35: 34.32321365137571}"
409,13,15,5.0,1,3,18,0.07302268462472632,"[7, 14, 2]",100.74523967368567,1.1583822871963112,15,work_charger,327,330,327,"{327: 100.74523967368567, 328: 99.58685738648936, 329: 96.11171052490043}"
409,9,10,24.37216707586218,3,8,18,0.08590904073497213,"[11, 8, 14]",132.78031832982523,4.994100451958371,10,work_charger,226,234,226,"{226: 132.78031832982523, 227: 127.78621787786686, 228: 112.80391652199175, 229: 87.8334142621999, 230: 52.874711098491304, 231: 7.927807030865964, 232: 0, 233: 0}"
409,1,11,13.161066232457351,2,7,18,0.08590904073497213,"[10, 11, 0]",100.5027088502294,1.9409383198825862,11,work_charger,35,42,35,"{35: 100.5027088502294, 36: 98.5617705303468, 37: 92.73895557069905, 38: 83.03426397128612, 39: 69.44769573210802, 40: 51.97925085316474, 41: 30.628929334456288}"
410,13,17,31.467965758712044,3,5,22,0.1742277345375333,"[0, 2, 13]",55.65479211853079,3.368078668168529,17,work_charger,329,334,329,"{329: 55.65479211853079, 330: 52.286713450362264, 331: 42.18247744585668, 332: 25.34208410501403, 333: 1.7655334278343275}"
410,4,12,68.06283160305159,7,9,21,0.11387433629904137,"[1, 13, 12]",148.54962713920855,4.746019923607381,12,work_charger,108,117,108,"{108: 148.54962713920855, 109: 143.80360721560118, 110: 129.56554744477904, 111: 105.83544782674213, 112: 72.61330836149045, 113: 29.899129049024026, 114: 0, 115: 0, 116: 0}"
410,10,9,42.478564217425614,4,6,15,0.17081150444856205,"[4, 11, 5]",102.18128787475204,3.041674039344663,9,work_charger,249,255,249,"{249: 102.18128787475204, 250: 99.13961383540737, 251: 90.01459171737339, 252: 74.80622152065007, 253: 53.514503245237435, 254: 26.139436891135475}"
410,0,12,59.82022279228458,3,7,19,0.11387433629904137,"[9, 14, 13]",138.1323959803288,2.020621355017519,12,work_charger,12,19,12,"{12: 138.1323959803288, 13: 136.11177462531128, 14: 130.04991056025872, 15: 119.94680378517113, 16: 105.80245430004848, 17: 87.61686210489081, 18: 65.39002719969811}"
411,2,10,39.34909804120876,3,5,15,0.20057147475403783,"[4, 10, 1]",107.2529873623784,4.2771449451364125,10,work_charger,58,63,58,"{58: 107.2529873623784, 59: 102.97584241724199, 60: 90.14440758183275, 61: 68.7586828561507, 62: 38.818668240195805}"
411,5,11,45.590767362623524,5,8,19,0.17048575354093218,"[3, 6, 14]",128.07878459797925,2.1303633301501295,11,work_charger,131,139,131,"{131: 128.07878459797925, 132: 125.94842126782912, 133: 119.55733127737874, 134: 108.90551462662809, 135: 93.99297131557718, 136: 74.81970134422602, 137: 51.385704712574594, 138: 23.690981420622904}"
411,5,14,46.99059977914534,4,6,20,0.17048575354093218,"[11, 6, 9]",88.45657494316248,2.2150458640711164,14,work_charger,134,140,134,"{134: 88.45657494316248, 135: 86.24152907909136, 136: 79.59639148687802, 137: 68.52116216652243, 138: 53.01584111802462, 139: 33.08042834138457}"
411,4,8,7.677127965139164,1,4,12,0.30085721213105676,"[7, 3, 9]",126.26724239765541,4.988820575897205,8,work_charger,104,108,104,"{104: 126.26724239765541, 105: 121.2784218217582, 106: 106.31196009406659, 107: 81.36785721458057}"
412,9,19,72.73795504053726,8,11,24,0.19643840592877376,"[6, 13, 1]",121.52429571211358,3.942754994680818,19,commuter,235,246,235,"{235: 121.52429571211358, 236: 117.58154071743277, 237: 105.75327573339031, 238: 86.03950075998623, 239: 58.440215797220496, 240: 22.95542084509313, 241: 0, 242: 0, 243: 0, 244: 0, 245: 0}"
412,5,17,43.56325269663937,3,5,22,0.1669726450394577,"[8, 2, 3]",130.0067076250989,3.0094619556908406,17,commuter,137,142,137,"{137: 130.0067076250989, 138: 126.99724566940806, 139: 117.96885980233553, 140: 102.92155002388134, 141: 81.85531633404545}"
412,10,19,51.50775974143822,7,8,24,0.19643840592877376,"[9, 8, 4]",120.64556853165807,4.3059357639242855,19,commuter,259,267,259,"{259: 120.64556853165807, 260: 116.33963276773379, 261: 103.42182547596093, 262: 81.8921466563395, 263: 51.750596308869504, 264: 12.997174433550938, 265: 0, 266: 0}"
412,5,14,25.229145203083046,4,5,19,0.0927625805774765,"[0, 11, 8]",122.49802459988352,4.158257252603855,14,commuter,134,139,134,"{134: 122.49802459988352, 135: 118.33976734727966, 136: 105.8649955894681, 137: 85.07370932644884, 138: 55.96590855822184}"
412,3,17,54.48657676105523,6,9,24,0.19643840592877376,"[12, 10, 2]",116.40723676838556,3.446589330950394,17,commuter,89,98,89,"{89: 116.40723676838556, 90: 112.96064743743517, 91: 102.62087944458398, 92: 85.387932789832, 93: 61.26180747317925, 94: 30.24250349462571, 95: 0, 96: 0, 97: 0}"
413,5,14,57.9666106295132,5,7,21,0.06376368667659783,"[6, 7, 12]",141.64653062325394,4.399126794960922,14,work_charger,134,141,134,"{134: 141.64653062325394, 135: 137.24740382829302, 136: 124.05002344341025, 137: 102.05438946860565, 138: 71.26050190387919, 139: 31.668360749230885, 140: 0}"
413,11,9,38.705400710857504,2,7,16,0.11252415295870205,"[11, 8, 6]",112.50945585613864,4.847166015244873,9,work_charger,273,280,273,"{273: 112.50945585613864, 274: 107.66228984089378, 275: 93.12079179515915, 276: 68.88496171893479, 277: 34.95479961222068, 278: 0, 279: 0}"
413,7,13,37.02507484481048,2,7,20,0.07501610197246804,"[9, 12, 6]",120.12382779042275,4.727685056955236,13,work_charger,181,188,181,"{181: 120.12382779042275, 182: 115.39614273346751, 183: 101.2130875626018, 184: 77.57466227782562, 185: 44.48086687913897, 186: 1.9317013665418443, 187: 0}"
414,5,13,29.682502523227093,3,8,21,0.1756725273961492,"[6, 5, 9]",145.44960284547795,3.7429749293219343,13,weekend_user,133,141,133,"{133: 145.44960284547795, 134: 141.706627916156, 135: 130.47770312819023, 136: 111.76282848158056, 137: 85.562003976327, 138: 51.87522961242959, 139: 10.70250538988833, 140: 0}"
415,13,21,60.110669359154684,6,11,24,0.07390724250182636,"[7, 6, 13]",140.53932329290052,2.807529974603728,21,night_charger,333,344,333,"{333: 140.53932329290052, 334: 137.73179331829678, 335: 129.30920339448562}"
415,7,22,42.8871827506402,3,8,24,0.08694969706097218,"[14, 8, 4]",80.51938344399527,4.186168264118583,22,night_charger,190,198,190,"{190: 80.51938344399527, 191: 76.33321517987669, 192: 63.77471038752093, 193: 42.843869066928015, 194: 13.540691218097933, 195: 0, 196: 0, 197: 0}"
416,12,19,62.701564459892374,8,12,24,0.2829967053349471,"[9, 14, 7]",109.76433466633833,1.1283780487717054,19,weekend_user,307,319,307,"{307: 109.76433466633833, 308: 108.63595661756662, 309: 105.25082247125151, 310: 99.60893222739298, 311: 91.71028588599104, 312: 81.5548834470457, 313: 69.14272491055694, 314: 54.47381027652476, 315: 37.54813954494918, 316: 18.365712715830185, 317: 0, 318: 0}"
417,2,9,35.340539938859976,3,7,16,0.13444213283844159,"[5, 7, 14]",59.918414687418284,3.221118248897992,9,work_charger,57,64,57,"{57: 59.918414687418284, 58: 56.69729643852029, 59: 47.033941691826314, 60: 30.928350447336356, 61: 8.38052270505041, 62: 0, 63: 0}"
417,8,10,21.580817093420848,3,5,15,0.08962808855896107,"[5, 9, 0]",123.5624150217509,1.1715470393576437,10,work_charger,202,207,202,"{202: 123.5624150217509, 203: 122.39086798239325, 204: 118.87622686432032, 205: 113.0184916675321, 206: 104.8176623920286}"
417,4,11,23.349866106554757,2,7,18,0.08962808855896107,"[2, 1, 11]",103.98214031716857,1.6274146094742887,11,work_charger,107,114,107,"{107: 103.98214031716857, 108: 102.35472570769429, 109: 97.47248187927141, 110: 89.33540883189997, 111: 77.94350656557995, 112: 63.296775080311356, 113: 45.395214376094174}"
418,9,19,53.31602041047924,4,10,24,0.16855333147958781,"[11, 0, 4]",110.85190982103903,2.429474716596475,19,night_charger,235,245,235,"{235: 110.85190982103903, 236: 108.42243510444256, 237: 101.13401095465314, 238: 88.98663737167075, 239: 71.98031435549544, 240: 50.11504190612715, 241: 23.390820023565936, 242: 0, 243: 0, 244: 0}"
418,2,20,28.92886046892199,4,11,24,0.16855333147958781,"[4, 2, 6]",53.710851153829665,3.6061991318139137,20,night_charger,68,79,68,"{68: 53.710851153829665, 69: 50.10465202201575, 70: 39.286054626574014, 71: 21.25505896750444, 72: 0, 73: 0, 74: 0, 75: 0, 76: 0, 77: 0, 78: 0}"
418,11,21,59.97767556579665,4,10,24,0.0936407397108821,"[10, 8, 12]",112.18745609820004,3.5363054184849947,21,night_charger,285,295,285,"{285: 112.18745609820004, 286: 108.65115067971504, 287: 98.04223442426007, 288: 80.3607073318351, 289: 55.60656940244013, 290: 23.779820636075172, 291: 0, 292: 0, 293: 0, 294: 0}"
419,1,19,56.74528471460632,4,6,24,0.2839910824004558,"[10, 8, 13]",149.68347619611583,4.116179480789729,19,random,43,49,43,"{43: 149.68347619611583, 44: 145.5672967153261, 45: 133.2187582729569, 46: 112.63786086900828, 47: 83.82460450348017, 48: 46.77898917637262}"
419,10,17,20.358140123293573,2,4,21,0.2839910824004558,"[11, 2, 10]",79.57239049516747,4.041084973611335,17,random,257,261,257,"{257: 79.57239049516747, 258: 75.53130552155613, 259: 63.40805060072213, 260: 43.20262573266545}"
419,7,17,36.81684118807041,6,8,24,0.2839910824004558,"[14, 9, 3]",66.30500200087062,4.0554310324565535,17,random,185,193,185,"{185: 66.30500200087062, 186: 62.24957096841406, 187: 50.0832778710444, 188: 29.806122708761634, 189: 1.4181054815657603, 190: 0, 191: 0, 192: 0}"
420,3,17,68.39956243093981,8,10,24,0.27307629282067514,"[5, 4, 11]",141.47324240549534,2.392629760576345,17,commuter,89,99,89,"{89: 141.47324240549534, 90: 139.080612644919, 91: 131.90272336318995, 92: 119.93957456030824, 93: 103.19116623627383, 94: 81.65749839108672, 95: 55.338571024746926, 96: 24.234384137254438, 97: 0, 98: 0}"
420,8,7,78.95653037972276,5,8,15,0.2275635773505626,"[9, 1, 2]",103.61419277969446,3.046123777904056,7,commuter,199,207,199,"{199: 103.61419277969446, 200: 100.5680690017904, 201: 91.42969766807823, 202: 76.19907877855796, 203: 54.87621233322957, 204: 27.46109833209306, 205: 0, 206: 0}"
420,12,14,41.826983412972275,3,4,18,0.1289526938319855,"[8, 10, 1]",137.598733170741,4.756276768404273,14,commuter,302,306,302,"{302: 137.598733170741, 303: 132.84245640233675, 304: 118.57362609712392, 305: 94.79224225510255}"
420,1,9,33.90227176205032,2,4,13,0.2275635773505626,"[5, 9, 11]",86.7387289151958,4.443161524121858,9,commuter,33,37,33,"{33: 86.7387289151958, 34: 82.29556739107393, 35: 68.96608281870836, 36: 46.750275198099075}"
421,9,7,64.71513291487594,6,8,15,0.13323210946290576,"[7, 8, 10]",84.78096495859168,2.175914523032273,7,commuter,223,231,223,"{223: 84.78096495859168, 224: 82.6050504355594, 225: 76.07730686646259, 226: 65.19773425130123, 227: 49.96633259007531, 228: 30.38310188278485, 229: 6.448042129429851, 230: 0}"
421,10,8,45.59770695846969,3,6,14,0.13323210946290576,"[14, 9, 12]",54.53772527803225,1.4261467744334877,8,commuter,248,254,248,"{248: 54.53772527803225, 249: 53.11157850359876, 250: 48.8331381802983, 251: 41.70240430813086, 252: 31.719376887096445, 253: 18.884055917195056}"
421,5,14,47.604050740867635,5,7,21,0.07549819536231327,"[10, 1, 9]",76.91898911947182,4.703383794934628,14,commuter,134,141,134,"{134: 76.91898911947182, 135: 72.2156053245372, 136: 58.10545393973331, 137: 34.58853496506016, 138: 1.6648484005177693, 139: 0, 140: 0}"
421,4,7,24.752061164640207,2,4,11,0.13323210946290576,"[12, 13, 2]",60.47638576811188,4.1855999550825835,7,commuter,103,107,103,"{103: 60.47638576811188, 104: 56.2907858130293, 105: 43.73398594778155, 106: 22.805986172368634}"
421,13,12,44.530991489564954,6,7,19,0.07549819536231327,"[1, 6, 14]",53.063569220614326,4.006967518023773,12,commuter,324,331,324,"{324: 53.063569220614326, 325: 49.056601702590555, 326: 37.035699148519235, 327: 17.000861558400373, 328: 0, 329: 0, 330: 0}"
422,11,22,65.83604270148422,7,12,24,0.1258211647193982,"[9, 7, 8]",145.15424351022676,2.6809418527678957,22,night_charger,286,298,286,"{286: 145.15424351022676, 287: 142.47330165745888, 288: 134.4304760991552, 289: 121.02576683531571, 290: 102.25917386594043, 291: 78.13069719102937, 292: 48.640336810582525, 293: 13.788092724599863, 294: 0, 295: 0, 296: 0, 297: 0}"
422,11,23,69.07306277273855,5,12,24,0.08807481530357875,"[7, 14, 8]",78.80440097848506,4.163107234290316,23,night_charger,287,299,287,"{287: 78.80440097848506, 288: 74.64129374419474, 289: 62.1519720413238, 290: 41.33643586987222, 291: 12.194685229840005, 292: 0, 293: 0, 294: 0, 295: 0, 296: 0, 297: 0, 298: 0}"
422,10,23,73.7168265634225,6,12,24,0.08807481530357875,"[0, 2, 3]",109.71993526591379,1.7787400252007468,23,night_charger,263,275,263,"{263: 109.71993526591379, 264: 107.94119524071304, 265: 102.6049751651108, 266: 93.71127503910706, 267: 81.26009486270183, 268: 65.25143463589512, 269: 45.6852943586869, 270: 22.561674031077203, 271: 0, 272: 0, 273: 0, 274: 0}"
423,9,7,24.047792036780088,2,3,10,0.140957391354292,"[10, 8, 12]",123.90127436095145,1.3275701128000192,7,commuter,223,226,223,"{223: 123.90127436095145, 224: 122.57370424815143, 225: 118.59099390975138}"
423,11,17,16.144479567548338,1,4,21,0.16914886962515044,"[0, 5, 9]",62.02656219887995,1.2847931779421295,17,commuter,281,285,281,"{281: 62.02656219887995, 282: 60.741769020937824, 283: 56.887389487111435, 284: 50.463423597400784}"
423,12,14,18.57328546435569,2,5,19,0.07987585510076549,"[12, 14, 1]",68.61300661083845,2.184572657605682,14,commuter,302,307,302,"{302: 68.61300661083845, 303: 66.42843395323277, 304: 59.87471598041573, 305: 48.95185269238732, 306: 33.65984408914754}"
423,9,19,30.18436093134498,2,5,24,0.16914886962515044,"[8, 6, 9]",56.868468621938874,1.5805587730645625,19,commuter,235,240,235,"{235: 56.868468621938874, 236: 55.287909848874314, 237: 50.54623352968062, 238: 42.643439664357814, 239: 31.579528252905874}"
424,13,17,58.86895023322331,8,12,24,0.3178775052544324,"[10, 7, 13]",99.9462134172914,3.9026218545754654,17,work_charger,329,341,329,"{329: 99.9462134172914, 330: 96.04359156271593, 331: 84.33572599898955, 332: 64.82261672611222, 333: 37.50426374408396, 334: 2.3806670529047693, 335: 0}"
424,4,13,65.78294681819386,5,7,20,0.2077630753296944,"[5, 7, 1]",78.20991618716505,3.53074386973003,13,work_charger,109,116,109,"{109: 78.20991618716505, 110: 74.67917231743502, 111: 64.08694070824492, 112: 46.43322135959478, 113: 21.71801427148457, 114: 0, 115: 0}"
424,5,15,51.993911570448944,4,7,22,0.17659861403024024,"[13, 8, 11]",51.90074000256713,2.8579706785132624,15,work_charger,135,142,135,"{135: 51.90074000256713, 136: 49.04276932405387, 137: 40.46885728851409, 138: 26.179003895947773, 139: 6.173209146354935, 140: 0, 141: 0}"
425,13,12,50.62243369491713,4,9,21,0.07167605769874094,"[7, 9, 2]",125.18897916419775,1.6124541236229337,12,weekend_user,324,333,324,"{324: 125.18897916419775, 325: 123.57652504057481, 326: 118.73916266970602, 327: 110.67689205159134, 328: 99.38971318623081, 329: 84.87762607362441, 330: 67.14063071377214, 331: 46.17872710667399, 332: 21.99191525232999}"
426,13,17,27.433764776069197,2,4,21,0.14652112171179818,"[0, 7, 11]",95.75370044770406,1.2056424279461444,17,work_charger,329,333,329,"{329: 95.75370044770406, 330: 94.54805801975792, 331: 90.93113073591948, 332: 84.90291859618875}"
426,6,14,30.64369585746387,2,4,18,0.08140062317322122,"[8, 5, 3]",50.47661304815364,2.5864413682216014,14,work_charger,158,162,158,"{158: 50.47661304815364, 159: 47.89017167993204, 160: 40.13084757526723, 161: 27.198640734159227}"
426,7,10,21.966537400863956,3,8,18,0.09576543902731907,"[13, 4, 6]",54.83624655952618,3.6125456432724934,10,work_charger,178,186,178,"{178: 54.83624655952618, 179: 51.22370091625369, 180: 40.386063986436206, 181: 22.32333577007374, 182: 0, 183: 0, 184: 0, 185: 0}"
426,12,14,27.86781173892024,3,8,22,0.08140062317322122,"[12, 6, 13]",76.06771268344865,2.5728870352169446,14,work_charger,302,310,302,"{302: 76.06771268344865, 303: 73.4948256482317, 304: 65.77616454258087, 305: 52.91172936649615, 306: 34.90152011997753, 307: 11.745536803025033, 308: 0, 309: 0}"
427,3,9,58.20167191220695,4,5,14,0.12094080898611827,"[5, 14, 9]",128.10977551241967,2.799458781445679,9,commuter,81,86,81,"{81: 128.10977551241967, 82: 125.310316730974, 83: 116.91194038663696, 84: 102.91464647940856, 85: 83.3184350092888}"
427,5,18,62.18638246958737,5,6,24,0.12335962516584063,"[4, 2, 13]",81.60797186795051,4.202765854297142,18,commuter,138,144,138,"{138: 81.60797186795051, 139: 77.40520601365337, 140: 64.79690845076195, 141: 43.783079179276235, 142: 14.363718199196242, 143: 0}"
427,2,17,56.70149234682736,3,6,23,0.14512897078334194,"[2, 13, 9]",55.39474768361122,1.6208271167171335,17,commuter,65,71,65,"{65: 55.39474768361122, 66: 53.77392056689409, 67: 48.911439216742686, 68: 40.80730363315702, 69: 29.461513816137085, 70: 14.874069765682883}"
427,7,9,59.06740043083778,5,7,16,0.12094080898611827,"[6, 8, 5]",66.19829269298243,1.7121181184214547,9,commuter,177,184,177,"{177: 66.19829269298243, 178: 64.48617457456098, 179: 59.34982021929662, 180: 50.78922962718934, 181: 38.80440279823916, 182: 23.395339732446068, 183: 4.562040429810068}"
428,10,9,48.48331152926043,7,8,17,0.3220918189669353,"[7, 5, 1]",126.14693289373167,4.672379172802156,9,commuter,249,257,249,"{249: 126.14693289373167, 250: 121.47455372092952, 251: 107.45741620252305, 252: 84.09552033851227, 253: 51.38886612889718, 254: 9.337453573677777, 255: 0, 256: 0}"
428,8,17,47.72880090848391,4,6,23,0.38651018276032245,"[1, 6, 2]",64.22975787979843,1.0076628247159962,17,commuter,209,215,209,"{209: 64.22975787979843, 210: 63.222095055082434, 211: 60.19910658093444, 212: 55.16079245735446, 213: 48.10715268434249, 214: 39.03818726189852}"
428,8,17,21.597129798449043,2,4,21,0.38651018276032245,"[10, 2, 4]",108.61071179372229,2.276109073493398,17,commuter,209,213,209,"{209: 108.61071179372229, 210: 106.33460272022889, 211: 99.5062754997487, 212: 88.1257301322817}"
428,7,19,56.47157456214721,7,8,24,0.38651018276032245,"[7, 5, 1]",72.03696905664916,1.8950891663234137,19,commuter,187,195,187,"{187: 72.03696905664916, 188: 70.14187989032574, 189: 64.4566123913555, 190: 54.98116655973843, 191: 41.715542395474536, 192: 24.659739898563814, 193: 3.8137590690062666, 194: 0}"
429,4,19,35.463117458336434,4,5,24,0.19431145996447888,"[8, 1, 5]",87.00620628699755,4.215505508576797,19,commuter,115,120,115,"{115: 87.00620628699755, 116: 82.79070077842076, 117: 70.14418425269037, 118: 49.06665670980638, 119: 19.558118149768802}"
429,12,13,71.50917480242558,6,8,21,0.09175818942767057,"[5, 14, 9]",140.4995225972325,1.7150340138842575,13,commuter,301,309,301,"{301: 140.4995225972325, 302: 138.78448858334824, 303: 133.63938654169547, 304: 125.06421647227418, 305: 113.05897837508438, 306: 97.62367225012606, 307: 78.75829809739923, 308: 56.46285591690388}"
429,4,8,40.13496786404084,2,4,12,0.16192621663706572,"[0, 13, 5]",57.374416514116064,4.518086370344349,8,commuter,104,108,104,"{104: 57.374416514116064, 105: 52.856330143771714, 106: 39.30207103273867, 107: 16.71163918101692}"
430,12,23,55.39736087668547,3,9,24,0.06381012383301156,"[1, 6, 13]",79.6210439800037,3.24260983456391,23,night_charger,311,320,311,"{311: 79.6210439800037, 312: 76.3784341454398, 313: 66.65060464174806, 314: 50.437555468928515, 315: 27.739286626981148, 316: 0, 317: 0, 318: 0, 319: 0}"
430,11,23,34.73925305299767,3,10,24,0.07507073392119007,"[7, 0, 8]",129.75209993180096,1.5286247892172908,23,night_charger,287,297,287,"{287: 129.75209993180096, 288: 128.22347514258365, 289: 123.6376007749318, 290: 115.99447682884534, 291: 105.2941033043243, 292: 91.53648020136868, 293: 74.72160751997848, 294: 54.8494852601537, 295: 31.920113421894342, 296: 5.933492005200392}"
431,3,8,63.5419307369886,7,12,20,0.21840607789837074,"[6, 14, 4]",140.16454232550885,3.3221260178309464,8,work_charger,80,92,80,"{80: 140.16454232550885, 81: 136.8424163076779, 82: 126.87603825418506, 83: 110.26540816503032, 84: 87.0105260402137, 85: 57.11139187973518, 86: 20.568005683594777, 87: 0, 88: 0, 89: 0, 90: 0, 91: 0}"
431,1,13,37.9338052483591,3,7,20,0.14560405193224718,"[11, 9, 2]",129.0157970569448,1.318068738098504,13,work_charger,37,44,37,"{37: 129.0157970569448, 38: 127.69772831884629, 39: 123.74352210455078, 40: 117.15317841405826, 41: 107.92669724736874, 42: 96.06407860448219, 43: 81.56532248539865}"
431,2,9,62.71139782382253,4,7,16,0.21840607789837074,"[5, 1, 6]",82.11220330581392,4.875064158272773,9,work_charger,57,64,57,"{57: 82.11220330581392, 58: 77.23713914754114, 59: 62.61194667272283, 60: 38.23662588135897, 61: 4.111176773449557, 62: 0, 63: 0}"
431,10,12,86.71524627112262,7,11,23,0.14560405193224718,"[13, 10, 5]",98.1251282371572,3.8420425981243653,12,work_charger,252,263,252,"{252: 98.1251282371572, 253: 94.28308563903283, 254: 82.75695784465974, 255: 63.54674485403791, 256: 36.652446667167354, 257: 2.0740632840480657, 258: 0, 259: 0, 260: 0, 261: 0, 262: 0}"
432,13,16,36.48939477107316,3,7,23,0.10735037381819568,"[8, 4, 9]",91.01497198886398,1.5816646003704595,16,weekend_user,328,335,328,"{328: 91.01497198886398, 329: 89.43330738849352, 330: 84.68831358738214, 331: 76.77999058552984, 332: 65.70833838293663, 333: 51.473356979602485, 334: 34.075046375527435}"
433,11,11,26.952009959526652,3,4,15,0.2693131918741218,"[11, 9, 4]",89.62805182393711,3.7610504367416047,11,random,275,279,275,"{275: 89.62805182393711, 276: 85.86700138719551, 277: 74.58385007697069, 278: 55.77859789326267}"
433,0,11,30.380717236794045,2,5,16,0.2693131918741218,"[1, 7, 5]",101.85474310440127,2.7595808081023305,11,random,11,16,11,"{11: 101.85474310440127, 12: 99.09516229629894, 13: 90.81641987199194, 14: 77.01851583148029, 15: 57.70145017476398}"
433,7,21,26.115787037838018,2,3,24,0.2693131918741218,"[11, 1, 4]",73.32049166502358,2.2636611298225437,21,random,189,192,189,"{189: 73.32049166502358, 190: 71.05683053520104, 191: 64.2658471457334}"
434,6,18,20.31084869153657,2,6,24,0.14177255344153647,"[4, 8, 7]",70.39623173087666,1.5863936542514243,18,weekend_user,162,168,162,"{162: 70.39623173087666, 163: 68.80983807662524, 164: 64.05065711387097, 165: 56.11868884261385, 166: 45.013933262853875, 167: 30.736390374591053}"
435,8,10,52.04920425089666,3,7,17,0.11329444451282648,"[14, 13, 9]",73.68607094403589,1.057480823706996,10,work_charger,202,209,202,"{202: 73.68607094403589, 203: 72.6285901203289, 204: 69.4561476492079, 205: 64.16874353067293, 206: 56.766377764723956, 207: 47.24905035136099, 208: 35.61676129058404}"
435,10,9,29.326245848303238,2,5,14,0.16994166676923972,"[8, 7, 14]",148.9088339856106,1.0810854907310334,9,work_charger,249,254,249,"{249: 148.9088339856106, 250: 147.8277484948796, 251: 144.58449202268648, 252: 139.1790645690313, 253: 131.61146613391406}"
435,2,10,32.77362946266021,2,7,17,0.11329444451282648,"[9, 14, 13]",57.7785200200468,1.4838310470180938,10,work_charger,58,65,58,"{58: 57.7785200200468, 59: 56.294688973028705, 60: 51.84319583197443, 61: 44.424040596883955, 62: 34.0372232677573, 63: 20.682743844594455, 64: 4.360602327395426}"
435,13,10,40.32828805049574,4,9,19,0.09630027783590252,"[7, 12, 10]",67.97066658855869,3.142059606708616,10,work_charger,322,331,322,"{322: 67.97066658855869, 323: 64.82860698185007, 324: 55.402428161724224, 325: 39.69213012818114, 326: 17.69771288122083, 327: 0, 328: 0, 329: 0, 330: 0}"
436,13,19,28.247915759021666,3,5,24,0.3912299188830104,"[3, 8, 14]",50.193730913686686,3.9548541505077104,19,commuter,331,336,331,"{331: 50.193730913686686, 332: 46.23887676317898, 333: 34.374314311655844, 334: 14.600043559117289, 335: 0}"
436,2,7,25.54012848801704,3,5,12,0.3835587440029513,"[3, 13, 6]",120.59181105982749,3.799294933375312,7,commuter,55,60,55,"{55: 120.59181105982749, 56: 116.79251612645218, 57: 105.39463132632625, 58: 86.39815665944968, 59: 59.8030921258225}"
436,0,19,42.519466043547865,3,6,24,0.46027049280354165,"[8, 3, 13]",133.9908332016071,1.9454576828227812,19,commuter,19,25,19,"{19: 133.9908332016071, 20: 132.0453755187843, 21: 126.20900247031598, 22: 116.48171405620207, 23: 102.86351027644261, 24: 85.35439113103757}"
437,4,12,41.12792786934063,3,7,19,0.09861065220608736,"[13, 8, 7]",109.68497479960806,4.270545343334016,12,work_charger,108,115,108,"{108: 109.68497479960806, 109: 105.41442945627404, 110: 92.602793426272, 111: 71.25006670960192, 112: 41.356249306263805, 113: 2.921341216257659, 114: 0}"
437,7,13,40.24436398009502,3,8,21,0.09861065220608736,"[14, 13, 10]",135.51958061969788,3.3087087814853704,13,work_charger,181,189,181,"{181: 135.51958061969788, 182: 132.2108718382125, 183: 122.28474549375639, 184: 105.74120158632954, 185: 82.58024011593196, 186: 52.80186108256362, 187: 16.406064486224537, 188: 0}"
437,6,16,57.26822384025099,6,9,24,0.08381905437517427,"[8, 6, 4]",84.96005038060167,3.6091875343865105,16,work_charger,160,169,160,"{160: 84.96005038060167, 161: 81.35086284621516, 162: 70.52330024305563, 163: 52.47736257112308, 164: 27.213049830417503, 165: 0, 166: 0, 167: 0, 168: 0}"
437,13,17,35.71668570957819,3,5,22,0.15087429787531367,"[12, 13, 6]",54.19263543779835,1.8164891382323907,17,work_charger,329,334,329,"{329: 54.19263543779835, 330: 52.37614629956596, 331: 46.92667888486879, 332: 37.844233193706835, 333: 25.1288092260801}"
438,7,7,36.856484801232305,3,6,13,0.18747295455060353,"[12, 6, 5]",136.7015078472009,2.240985698750442,7,commuter,175,181,175,"{175: 136.7015078472009, 176: 134.46052214845045, 177: 127.73756505219913, 178: 116.53263655844692, 179: 100.84573666719382, 180: 80.67686537843986}"
438,5,10,48.224139431934766,4,6,16,0.10623467424534203,"[12, 4, 11]",147.10073912780118,4.361346610977197,10,commuter,130,136,130,"{130: 147.10073912780118, 131: 142.73939251682398, 132: 129.65535268389237, 133: 107.84861962900641, 134: 77.31919335216602, 135: 38.067073853371255}"
438,6,12,55.14576232639598,5,6,18,0.10623467424534203,"[5, 14, 2]",121.43651619473286,3.136037269228757,12,commuter,156,162,156,"{156: 121.43651619473286, 157: 118.30047892550411, 158: 108.89236711781783, 159: 93.21218077167404, 160: 71.25991988707275, 161: 43.03558446401394}"
439,4,7,51.83057714316635,3,5,12,0.4078363384166456,"[1, 4, 14]",119.31870037873944,3.2457960692440184,7,commuter,103,108,103,"{103: 119.31870037873944, 104: 116.07290430949541, 105: 106.33551610176336, 106: 90.10653575554326, 107: 67.38596327083513}"
439,12,15,37.980562863880465,3,4,19,0.23110725843609922,"[14, 11, 7]",83.15055984252535,4.900570797544404,15,commuter,303,307,303,"{303: 83.15055984252535, 304: 78.24998904498095, 305: 63.54827665234774, 306: 39.04542266462572}"
439,10,7,33.79682510865522,3,6,13,0.4078363384166456,"[14, 1, 8]",108.81024443177026,2.703533857860117,7,commuter,247,253,247,"{247: 108.81024443177026, 248: 106.10671057391014, 249: 97.9961090003298, 250: 84.47843971102921, 251: 65.55370270600838, 252: 41.22189798526733}"
439,13,19,29.46789302186562,2,3,22,0.4159930651849785,"[12, 3, 14]",93.74582272971705,4.799373059222381,19,commuter,331,334,331,"{331: 93.74582272971705, 332: 88.94644967049467, 333: 74.54833049282752}"
440,2,21,43.0779983190254,4,11,24,0.07674944251589973,"[10, 2, 5]",56.83811221074314,3.392405667960054,21,night_charger,69,80,69,"{69: 56.83811221074314, 70: 53.445706542783086, 71: 43.26848953890293, 72: 26.306461199102653, 73: 2.559621523382276, 74: 0, 75: 0, 76: 0, 77: 0, 78: 0, 79: 0}"
440,9,22,49.02940538681561,3,10,24,0.07674944251589973,"[4, 3, 1]",87.03478712854223,2.4757167812575793,22,night_charger,238,248,238,"{238: 87.03478712854223, 239: 84.55907034728466, 240: 77.13192000351192, 241: 64.75333609722402, 242: 47.423318628420965, 243: 25.141867597102753, 244: 0, 245: 0, 246: 0, 247: 0}"
440,11,21,47.69991973782077,4,10,24,0.07674944251589973,"[8, 4, 6]",81.77435047620818,3.3277116199228853,21,night_charger,285,295,285,"{285: 81.77435047620818, 286: 78.4466388562853, 287: 68.46350399651664, 288: 51.824945896902214, 289: 28.53096455744202, 290: 0, 291: 0, 292: 0, 293: 0, 294: 0}"
441,4,8,41.62423849227589,4,5,13,0.11696403687929625,"[9, 8, 1]",149.36980301271583,4.0106160048451205,8,commuter,104,109,104,"{104: 149.36980301271583, 105: 145.3591870078707, 106: 133.32733899333536, 107: 113.27425896910975, 108: 85.1999469351939}"
441,12,13,60.30596592759976,4,5,18,0.06627962089826789,"[8, 9, 14]",101.27624968989255,3.205867514949079,13,commuter,301,306,301,"{301: 101.27624968989255, 302: 98.07038217494348, 303: 88.45277963009623, 304: 72.42344205535085, 305: 49.98236945070729}"
441,11,8,49.570227478203975,4,7,15,0.11696403687929625,"[4, 7, 3]",68.5127150573218,4.439768948967544,8,commuter,272,279,272,"{272: 68.5127150573218, 273: 64.07294610835426, 274: 50.753639261451625, 275: 28.55479451661391, 276: 0, 277: 0, 278: 0}"
441,2,18,37.13920304079746,3,4,22,0.14035684425515552,"[7, 14, 9]",121.72054798944384,2.7249479655624285,18,commuter,66,70,66,"{66: 121.72054798944384, 67: 118.99560002388142, 68: 110.82075612719413, 69: 97.196016299382}"
441,6,17,70.72984721429503,8,11,24,0.11930331761688218,"[11, 5, 3]",73.06197692536054,4.564708316646858,17,commuter,161,172,161,"{161: 73.06197692536054, 162: 68.49726860871368, 163: 54.80314365877311, 164: 31.97960207553882, 165: 0.026643859010818005, 166: 0, 167: 0, 168: 0, 169: 0, 170: 0, 171: 0}"
442,0,20,69.04309977343823,4,10,24,0.2127066838177122,"[14, 5, 2]",104.90299292113377,3.350826411396271,20,night_charger,20,30,20,"{20: 104.90299292113377, 21: 101.5521665097375, 22: 91.4996872755487, 23: 74.74555521856733, 24: 51.28977033879344, 25: 21.132332636227005, 26: 0, 27: 0, 28: 0, 29: 0}"
442,13,23,37.895102009133176,3,11,24,0.07031137603974376,"[7, 8, 14]",86.65390544089561,4.920396412431911,23,night_charger,335,346,335,{335: 86.65390544089561}
443,4,21,24.838846480310185,2,10,24,0.23418888165804344,"[2, 6, 0]",94.50452833148654,4.953618768623786,21,night_charger,117,127,117,"{117: 94.50452833148654, 118: 89.55090956286276, 119: 74.6900532569914, 120: 49.92195941387247, 121: 15.24662803350597, 122: 0, 123: 0, 124: 0, 125: 0, 126: 0}"
443,5,22,18.585513659346116,1,8,24,0.19906054940933693,"[6, 8, 7]",133.02435279704073,1.9258126852785615,22,night_charger,142,150,142,"{142: 133.02435279704073, 143: 131.09854011176216, 144: 125.32110205592649, 145: 115.69203862953368, 146: 102.21134983258375, 147: 84.8790356650767, 148: 63.69509612701252, 149: 38.65953121839122}"
443,4,19,35.610804648827454,3,10,24,0.42153998698447825,"[5, 0, 11]",147.21820779667604,3.48114803795404,19,night_charger,115,125,115,"{115: 147.21820779667604, 116: 143.737059758722, 117: 133.29361564485987, 118: 115.88787545508968, 119: 91.5198391894114, 120: 60.189506847825044, 121: 21.896878430330602, 122: 0, 123: 0, 124: 0}"
444,10,21,66.91353874678472,7,9,24,0.09191560396220515,"[10, 14, 7]",92.71747896730093,2.14695875775718,21,random,261,270,261,"{261: 92.71747896730093, 262: 90.57052020954376, 263: 84.12964393627222, 264: 73.39485014748632, 265: 58.36613884318606, 266: 39.04351002337144, 267: 15.426963688042463, 268: 0, 269: 0}"
445,3,18,54.861987179846594,4,5,23,0.21811190777954595,"[9, 6, 4]",77.64903956848788,1.2004217060198874,18,commuter,90,95,90,"{90: 77.64903956848788, 91: 76.448617862468, 92: 72.84735274440833, 93: 66.84524421430889, 94: 58.44229227216968}"
445,11,18,56.441406224755674,5,6,24,0.21811190777954595,"[13, 2, 14]",59.66519395819043,3.046952482811673,18,commuter,282,288,282,"{282: 59.66519395819043, 283: 56.61824147537875, 284: 47.47738402694374, 285: 32.24262161288537, 286: 10.913954233203661, 287: 0}"
445,0,17,89.71349636295255,5,6,23,0.21811190777954595,"[14, 6, 13]",64.54913574570142,4.897999533051133,17,commuter,17,23,17,"{17: 64.54913574570142, 18: 59.651136212650286, 19: 44.95713761349689, 20: 20.467139948241226, 21: 0, 22: 0}"
445,2,9,62.709545754393574,4,6,15,0.18175992314962158,"[14, 12, 5]",80.29909306643546,1.3905129584340976,9,commuter,57,63,57,"{57: 80.29909306643546, 58: 78.90858010800136, 59: 74.73704123269907, 60: 67.78447644052858, 61: 58.0508857314899, 62: 45.53626910558302}"
446,12,18,53.44803584838402,5,6,24,0.24064897399073074,"[13, 5, 9]",89.75660087891771,1.2961251496236543,18,random,306,312,306,"{306: 89.75660087891771, 307: 88.46047572929406, 308: 84.57210028042309, 309: 78.09147453230482, 310: 69.01859848493925, 311: 57.35347213832635}"
446,12,21,67.50145811293763,6,10,24,0.13369387443929487,"[7, 8, 6]",62.76119049919451,4.06351926313512,21,random,309,319,309,"{309: 62.76119049919451, 310: 58.69767123605939, 311: 46.50711344665403, 312: 26.18951713097843, 313: 0, 314: 0, 315: 0, 316: 0, 317: 0, 318: 0}"
447,3,7,22.585653173045678,2,6,13,0.1818729617642597,"[5, 7, 9]",132.3072516508348,2.498268550172162,7,random,79,85,79,"{79: 132.3072516508348, 80: 129.80898310066263, 81: 122.31417745014613, 82: 109.82283469928532, 83: 92.3349548480802, 84: 69.85053789653074}"
448,11,18,36.06199845374043,4,7,24,0.2103350514263066,"[3, 1, 10]",100.34506940020357,3.289150775777029,18,random,282,289,282,"{282: 100.34506940020357, 283: 97.05591862442654, 284: 87.18846629709546, 285: 70.74271241821032, 286: 47.718656987771105, 287: 18.116300005777845, 288: 0}"
449,7,9,35.247611803329534,5,9,18,0.16740230075898638,"[13, 1, 12]",89.05162605582657,3.979697069131999,9,random,177,186,177,"{177: 89.05162605582657, 178: 85.07192898669457, 179: 73.13283777929858, 180: 53.234352433638584, 181: 25.37647294971459, 182: 0, 183: 0, 184: 0, 185: 0}"
449,1,16,26.084826613969028,3,6,22,0.11160153383932427,"[3, 5, 9]",86.71431593120738,3.691575215957155,16,random,40,46,40,"{40: 86.71431593120738, 41: 83.02274071525022, 42: 71.94801506737876, 43: 53.490138987592985, 44: 27.6491124758929, 45: 0}"
450,10,8,26.185072496451976,4,7,15,0.1936590733802931,"[10, 4, 13]",122.18427497552398,1.9363916760959978,8,commuter,248,255,248,"{248: 122.18427497552398, 249: 120.24788329942798, 250: 114.43870827113999, 251: 104.75674989065999, 252: 91.20200815798802, 253: 73.77448307312403, 254: 52.47417463606806}"
450,8,7,17.207225522616916,2,5,12,0.1936590733802931,"[2, 5, 3]",86.14441543250022,2.957324320729713,7,commuter,199,204,199,"{199: 86.14441543250022, 200: 83.18709111177051, 201: 74.31511814958137, 202: 59.52849654593281, 203: 38.82722630082482}"
450,3,7,27.128139641172588,2,5,12,0.1936590733802931,"[14, 13, 1]",92.60441034642619,3.1364799241013683,7,commuter,79,84,79,"{79: 92.60441034642619, 80: 89.46793042232483, 81: 80.05849065002072, 82: 64.37609102951387, 83: 42.4207315608043}"
450,8,8,24.503029859338874,3,6,14,0.1936590733802931,"[8, 11, 2]",144.64728292974468,2.3713804275286745,8,commuter,200,206,200,"{200: 144.64728292974468, 201: 142.275902502216, 202: 135.16176121962997, 203: 123.3048590819866, 204: 106.70519608928589, 205: 85.36277224152781}"
451,0,8,27.822724032987296,4,7,15,0.15972933136904177,"[5, 11, 13]",126.68036652069574,1.136785942283332,8,random,8,15,8,"{8: 126.68036652069574, 9: 125.54358057841242, 10: 122.13322275156241, 11: 116.44929304014576, 12: 108.49179144416243, 13: 98.26071796361245, 14: 85.75607259849579}"
452,5,19,38.547308242819355,4,7,24,0.12219783161191136,"[6, 1, 0]",79.42504080884612,3.347519167187036,19,commuter,139,146,139,"{139: 79.42504080884612, 140: 76.07752164165909, 141: 66.03496414009797, 142: 49.297368304162795, 143: 25.864734133853545, 144: 0, 145: 0}"
452,3,9,63.54876047739276,4,5,14,0.11980179569795231,"[6, 10, 14]",66.1875313733318,1.2507050729392137,9,commuter,81,86,81,"{81: 66.1875313733318, 82: 64.93682630039258, 83: 61.18471108157494, 84: 54.93118571687887, 85: 46.176250206304374}"
452,6,12,41.78291901006473,3,5,17,0.06788768422883965,"[4, 8, 2]",96.87787382810221,4.9951714034221535,12,commuter,156,161,156,"{156: 96.87787382810221, 157: 91.88270242468006, 158: 76.8971882144136, 159: 51.92133119730283, 160: 16.955131373347754}"
453,1,23,49.50144166518381,7,12,24,0.1006323419473963,"[2, 0, 11]",114.40946934361857,1.7122617532989284,23,night_charger,47,59,47,"{47: 114.40946934361857, 48: 112.69720759031964, 49: 107.56042233042285, 50: 98.9991135639282, 51: 87.01328129083572, 52: 71.60292551114536, 53: 52.768046224857144, 54: 30.50864343197108, 55: 4.824717132487152, 56: 0, 57: 0, 58: 0}"
453,1,21,30.764965223253014,3,11,24,0.14376048849628043,"[4, 5, 9]",56.78847118656988,2.542543841682502,21,night_charger,45,56,45,"{45: 56.78847118656988, 46: 54.24592734488738, 47: 46.61829581983987, 48: 33.905576611427364, 49: 16.107769719649845, 50: 0, 51: 0, 52: 0, 53: 0, 54: 0, 55: 0}"
453,3,21,35.366651014880254,5,12,24,0.14376048849628043,"[4, 9, 8]",111.79555210432505,3.731927969307907,21,night_charger,93,105,93,"{93: 111.79555210432505, 94: 108.06362413501715, 95: 96.86784022709342, 96: 78.20820038055389, 97: 52.08470459539854, 98: 18.497352871627385, 99: 0, 100: 0, 101: 0, 102: 0, 103: 0, 104: 0}"
454,2,12,13.758828715561926,1,6,18,0.09442426628611211,"[1, 9, 5]",131.54997271035194,2.7231418741150692,12,work_charger,60,66,60,"{60: 131.54997271035194, 61: 128.82683083623687, 62: 120.65740521389166, 63: 107.04169584331632, 64: 87.97970272451083, 65: 63.47142585747521}"
454,2,8,18.167118086088447,2,5,13,0.14163639942916814,"[13, 4, 10]",143.0756471962152,3.7645407525029833,8,work_charger,56,61,56,"{56: 143.0756471962152, 57: 139.3111064437122, 58: 128.01748418620326, 59: 109.19478042368834, 60: 82.84299515616746}"
454,2,8,12.88920768871504,2,5,13,0.14163639942916814,"[8, 9, 11]",147.13297002123198,4.513034765756586,8,work_charger,56,61,56,"{56: 147.13297002123198, 57: 142.6199352554754, 58: 129.08083095820564, 59: 106.5156571294227, 60: 74.9244137691266}"
454,11,9,23.50049587825801,3,5,14,0.14163639942916814,"[2, 8, 4]",121.18972503066855,3.931657196678021,9,work_charger,273,278,273,"{273: 121.18972503066855, 274: 117.25806783399054, 275: 105.46309624395647, 276: 85.80481026056637, 277: 58.28320988382022}"
455,12,15,32.55808365386141,3,6,21,0.06923031180061182,"[4, 1, 13]",58.66574053941712,2.169179063447263,15,random,303,309,303,"{303: 58.66574053941712, 304: 56.496561475969855, 305: 49.98902428562807, 306: 39.14312896839175, 307: 23.95887552426091, 308: 4.436263953235546}"
456,6,12,36.371516793203895,5,6,18,0.10768863821603519,"[11, 8, 4]",82.6309481823363,1.2866083919343443,12,random,156,162,156,"{156: 82.6309481823363, 157: 81.34433979040195, 158: 77.48451461459892, 159: 71.0514726549272, 160: 62.04521391138679, 161: 50.46573838397769}"
457,12,11,29.65868320424751,2,7,18,0.10942480059442652,"[8, 11, 13]",138.58242910466237,4.1533095824847095,11,weekend_user,299,306,299,"{299: 138.58242910466237, 300: 134.42911952217764, 301: 121.96919077472353, 302: 101.20264286229998, 303: 72.12947578490702, 304: 34.74968954254463, 305: 0}"
457,13,10,27.781360672942437,3,7,17,0.10942480059442652,"[7, 9, 3]",115.56198804449888,2.826403696823263,10,weekend_user,322,329,322,"{322: 115.56198804449888, 323: 112.73558434767561, 324: 104.25637325720582, 325: 90.12435477308951, 326: 70.33952889532667, 327: 44.9018956239173, 328: 13.811454958861404}"
458,8,11,34.65633015836439,3,7,18,0.10690038583795797,"[5, 2, 0]",117.57386646535419,1.8585788559590228,11,work_charger,203,210,203,"{203: 117.57386646535419, 204: 115.71528760939516, 205: 110.13955104151809, 206: 100.84665676172298, 207: 87.83660477000981, 208: 71.10939506637862, 209: 50.66502765082936}"
458,1,9,35.483886509461776,3,7,16,0.16035057875693692,"[13, 11, 0]",94.35091017801145,2.3733237566097016,9,work_charger,33,40,33,"{33: 94.35091017801145, 34: 91.97758642140174, 35: 84.85761515157265, 36: 72.99099636852414, 37: 56.37773007225622, 38: 35.0178162627689, 39: 8.911254940062193}"
458,9,11,21.409378914061822,3,5,16,0.10690038583795797,"[4, 2, 8]",84.45682294587749,2.2362169680013992,11,work_charger,227,232,227,"{227: 84.45682294587749, 228: 82.22060597787609, 229: 75.51195507387189, 230: 64.3308702338649, 231: 48.6773514578551}"
458,4,12,32.73734395505067,2,5,17,0.10690038583795797,"[14, 1, 13]",92.8473098156582,2.5114639662468883,12,work_charger,108,113,108,"{108: 92.8473098156582, 109: 90.33584584941131, 110: 82.80145395067065, 111: 70.24413411943621, 112: 52.663886355707994}"
459,6,10,20.36524418473148,1,4,14,0.09191771900652775,"[14, 7, 9]",95.02986262437467,2.2875186035444823,10,weekend_user,154,158,154,"{154: 95.02986262437467, 155: 92.74234402083019, 156: 85.87978821019675, 157: 74.44219519247433}"
460,11,10,64.45495012463495,5,8,18,0.08772524850611951,"[1, 9, 13]",71.7549430014358,1.7330234587562487,10,work_charger,274,282,274,"{274: 71.7549430014358, 275: 70.02191954267956, 276: 64.8228491664108, 277: 56.15773187262957, 278: 44.026567661335825, 279: 28.42935653252959, 280: 9.366098486210852, 281: 0}"
460,11,8,40.314454108384545,4,9,17,0.13158787275917927,"[13, 10, 7]",103.4387964285767,4.815860933301097,8,work_charger,272,281,272,"{272: 103.4387964285767, 273: 98.6229354952756, 274: 84.17535269537231, 275: 60.096048028866825, 276: 26.385021495759148, 277: 0, 278: 0, 279: 0, 280: 0}"
460,4,11,41.31779339449214,4,9,20,0.08772524850611951,"[14, 3, 8]",54.97182924879691,3.6196141291405604,11,work_charger,107,116,107,"{107: 54.97182924879691, 108: 51.35221511965635, 109: 40.49337273223467, 110: 22.395302086531863, 111: 0, 112: 0, 113: 0, 114: 0, 115: 0}"
461,8,9,67.6301789528582,7,10,19,0.18522709747830982,"[8, 7, 3]",101.2223057447539,2.7554201126720232,9,commuter,201,211,201,"{201: 101.2223057447539, 202: 98.46688563208187, 203: 90.2006252940658, 204: 76.42352473070568, 205: 57.135583942001524, 206: 32.336802927953315, 207: 2.0271816885610576, 208: 0, 209: 0, 210: 0}"
461,12,15,52.119349586782555,5,6,21,0.10496202190437558,"[8, 5, 4]",79.52814366136144,4.392275126679221,15,commuter,303,309,303,"{303: 79.52814366136144, 304: 75.13586853468222, 305: 61.95904315464456, 306: 39.99766752124845, 307: 9.25174163449391, 308: 0}"
461,2,19,76.39295463304765,5,6,24,0.22227251697397182,"[7, 5, 8]",121.74771676920794,3.0664222521407978,19,commuter,67,73,67,"{67: 121.74771676920794, 68: 118.68129451706714, 69: 109.48202776064475, 70: 94.14991649994076, 71: 72.68496073495518, 72: 45.087160465688}"
461,10,18,75.62556484674843,8,9,24,0.22227251697397182,"[1, 9, 4]",75.88303100692805,3.994975406657933,18,commuter,258,267,258,"{258: 75.88303100692805, 259: 71.88805560027012, 260: 59.90312938029632, 261: 39.928252347006655, 262: 11.963424500401125, 263: 0, 264: 0, 265: 0, 266: 0}"
462,13,18,40.68035347854477,5,6,24,0.11508464171373825,"[7, 6, 5]",50.020139813431044,4.564116074445009,18,commuter,330,336,330,"{330: 50.020139813431044, 331: 45.45602373898603, 332: 31.76367551565101, 333: 8.943095143425964, 334: 0, 335: 0}"
462,3,9,36.63735313990594,2,3,12,0.11282808011150809,"[13, 9, 8]",141.31265747570347,3.2393348995985507,9,commuter,81,84,81,"{81: 141.31265747570347, 82: 138.0733225761049, 83: 128.35531787730926}"
462,13,17,22.13428390176444,2,3,20,0.11508464171373825,"[11, 8, 0]",113.63658101666421,3.9955251186637373,17,commuter,329,332,329,"{329: 113.63658101666421, 330: 109.64105589800047, 331: 97.65448054200925}"
462,8,9,19.086859794845516,1,3,12,0.11282808011150809,"[3, 5, 13]",89.14977382852666,4.285065877696578,9,commuter,201,204,201,"{201: 89.14977382852666, 202: 84.86470795083008, 203: 72.00951031774035}"
463,12,9,56.91660084545907,4,7,16,0.32458861711171544,"[2, 0, 6]",136.72263587993717,1.4800880548139435,9,random,297,304,297,"{297: 136.72263587993717, 298: 135.24254782512324, 299: 130.8022836606814, 300: 123.40184338661169, 301: 113.04122700291407, 302: 99.72043450958859, 303: 83.4394659066352}"
464,9,8,81.17496799536764,8,11,19,0.4457636646230859,"[0, 2, 6]",109.2779693976749,4.100845268936685,8,commuter,224,235,224,"{224: 109.2779693976749, 225: 105.17712412873821, 226: 92.87458832192816, 227: 72.37036197724473, 228: 43.664445094687935, 229: 6.756837674257767, 230: 0, 231: 0, 232: 0, 233: 0, 234: 0}"
464,13,18,52.609295694611895,6,9,24,0.45467893791554764,"[2, 14, 4]",138.84935388643547,2.3119933934841588,18,commuter,330,339,330,"{330: 138.84935388643547, 331: 136.5373604929513, 332: 129.60138031249883, 333: 118.04141334507804, 334: 101.85745959068893, 335: 81.0495190493315}"
464,7,9,69.95454853936805,8,9,18,0.4457636646230859,"[1, 0, 8]",130.09647647678185,2.415975401905065,9,commuter,177,186,177,"{177: 130.09647647678185, 178: 127.68050107487679, 179: 120.43257486916158, 180: 108.35269785963627, 181: 91.4408700463008, 182: 69.69709142915522, 183: 43.1213620081995, 184: 11.713681783433657, 185: 0}"
464,8,8,38.88479006959203,2,3,11,0.4457636646230859,"[11, 1, 9]",94.12760698718864,4.345020037485611,8,commuter,200,203,200,"{200: 94.12760698718864, 201: 89.78258694970303, 202: 76.7475268372462}"
465,1,20,34.66353128849214,3,6,24,0.184893835700422,"[3, 0, 5]",95.9063168755417,4.858055333717752,20,random,44,50,44,"{44: 95.9063168755417, 45: 91.04826154182395, 46: 76.4740955406707, 47: 52.183818872081936, 48: 18.177431536057668, 49: 0}"
466,8,17,30.60197218892697,2,4,21,0.2849146047249091,"[8, 10, 5]",59.13617373088768,4.8494870172135265,17,commuter,209,213,209,"{209: 59.13617373088768, 210: 54.28668671367415, 211: 39.73822566203357, 212: 15.490790575965939}"
466,1,17,27.397803398444985,2,4,21,0.2849146047249091,"[6, 2, 12]",114.52659590665166,4.47665699532334,17,commuter,41,45,41,"{41: 114.52659590665166, 42: 110.04993891132833, 43: 96.61996792535831, 44: 74.2366829487416}"
466,7,18,31.063317908054103,4,7,24,0.2849146047249091,"[9, 0, 4]",60.007831371148036,2.2010364405287106,18,commuter,186,193,186,"{186: 60.007831371148036, 187: 57.806794930619326, 188: 51.203685609033194, 189: 40.19850340638964, 190: 24.791248322688666, 191: 4.981920357930271, 192: 0}"
466,9,18,20.29755553699511,3,4,22,0.2849146047249091,"[2, 11, 4]",81.49006328649307,4.479803775665676,18,commuter,234,238,234,"{234: 81.49006328649307, 235: 77.0102595108274, 236: 63.570848183830364, 237: 41.17182930550199}"
466,13,15,27.54766220063945,3,5,20,0.13454300778676262,"[2, 5, 3]",89.13906643822696,4.847146457234242,15,commuter,327,332,327,"{327: 89.13906643822696, 328: 84.29191998099272, 329: 69.75048060929, 330: 45.51474832311878, 331: 11.58472312247909}"
467,9,12,71.80423645801619,4,7,19,0.1743023524711423,"[10, 7, 6]",73.29920525459397,2.546528768854823,12,random,228,235,228,"{228: 73.29920525459397, 229: 70.75267648573914, 230: 63.11309017917468, 231: 50.38044633490057, 232: 32.554744952916806, 233: 9.635986033223404, 234: 0}"
467,7,12,83.76018977030122,7,8,20,0.1743023524711423,"[14, 2, 13]",90.49292199404275,2.0771059340430065,12,random,180,188,180,"{180: 90.49292199404275, 181: 88.41581605999974, 182: 82.18449825787071, 183: 71.79896858765568, 184: 57.25922704935464, 185: 38.56527364296758, 186: 15.717108368494507, 187: 0}"
468,10,20,27.133726369262117,2,10,24,0.2789692462424639,"[12, 8, 5]",53.347606457822614,4.661707622702478,20,night_charger,260,270,260,"{260: 53.347606457822614, 261: 48.685898835120135, 262: 34.7007759670127, 263: 11.392237853500312, 264: 0, 265: 0, 266: 0, 267: 0, 268: 0, 269: 0}"
468,0,22,27.46663116910513,3,10,24,0.15498291457914656,"[9, 0, 5]",64.82191098035166,2.73287454071138,22,night_charger,22,32,22,"{22: 64.82191098035166, 23: 62.08903643964028, 24: 53.89041281750614, 25: 40.22604011394924, 26: 21.09591832896958, 27: 0, 28: 0, 29: 0, 30: 0, 31: 0}"
468,7,21,37.98674592706933,2,10,24,0.15498291457914656,"[2, 4, 0]",108.43376360811219,3.4301351651122007,21,night_charger,189,199,189,"{189: 108.43376360811219, 190: 105.00362844299998, 191: 94.71322294766338, 192: 77.56254712210239, 193: 53.551600966316975, 194: 22.68038448030717, 195: 0, 196: 0, 197: 0, 198: 0}"
469,13,20,19.12599661117724,2,10,24,0.25959443274359895,"[4, 6, 9]",87.33861045473418,4.100149706172775,20,night_charger,332,342,332,"{332: 87.33861045473418, 333: 83.23846074856141, 334: 70.93801163004308, 335: 50.437263099179205}"
469,13,23,32.241728132471465,2,8,24,0.10095339051139961,"[4, 9, 8]",83.36785210122822,1.3792625853225697,23,night_charger,335,343,335,{335: 83.36785210122822}
470,12,19,44.26522992413017,5,6,24,0.42018724186854284,"[9, 4, 13]",78.33401908733505,2.4675406065499557,19,random,307,313,307,"{307: 78.33401908733505, 308: 75.86647848078509, 309: 68.46385666113522, 310: 56.12615362838545, 311: 38.85336938253576, 312: 16.645503923586162}"
470,10,21,43.67917852667814,3,7,24,0.2746321842278058,"[6, 5, 9]",61.60185112791395,1.370545474751224,21,random,261,268,261,"{261: 61.60185112791395, 262: 60.23130565316273, 263: 56.11966922890906, 264: 49.266941855152936, 265: 39.67312353189437, 266: 27.338214259133352, 267: 12.262214036869885}"
471,4,11,41.772266923867775,3,5,16,0.07663619958367106,"[11, 13, 1]",117.04097766011185,1.9639423581851783,11,work_charger,107,112,107,"{107: 117.04097766011185, 108: 115.07703530192667, 109: 109.18520822737113, 110: 99.36549643644524, 111: 85.61789992914899}"
471,11,11,55.395978298834606,6,9,20,0.07663619958367106,"[11, 5, 14]",53.60410752652008,4.91621602906717,11,work_charger,275,284,275,"{275: 53.60410752652008, 276: 48.68789149745291, 277: 33.9392434102514, 278: 9.358163264915547, 279: 0, 280: 0, 281: 0, 282: 0, 283: 0}"
471,3,11,43.62540626144029,4,8,19,0.07663619958367106,"[3, 1, 12]",65.74513336462653,1.746026731143104,11,work_charger,83,91,83,"{83: 65.74513336462653, 84: 63.99910663348342, 85: 58.76102644005411, 86: 50.03089278433859, 87: 37.80870566633686, 88: 22.094465086048928, 89: 2.8881710434747845, 90: 0}"
472,8,9,52.722035809403316,3,7,16,0.27071960541004547,"[8, 12, 11]",133.17211254931857,1.8460263519094497,9,random,201,208,201,"{201: 133.17211254931857, 202: 131.32608619740913, 203: 125.78800714168077, 204: 116.55787538213352, 205: 103.63569091876738, 206: 87.02145375158233, 207: 66.71516388057837}"
473,7,10,21.462621732033746,3,7,17,0.09368883033524684,"[9, 12, 5]",54.48404368399128,3.8553897985149073,10,work_charger,178,185,178,"{178: 54.48404368399128, 179: 50.628653885476375, 180: 39.06248448993165, 181: 19.785535497357117, 182: 0, 183: 0, 184: 0}"
473,4,9,69.56750788092171,5,7,16,0.14053324550287027,"[13, 4, 2]",93.03494979304274,4.143253876756552,9,work_charger,105,112,105,"{105: 93.03494979304274, 106: 88.8916959162862, 107: 76.46193428601653, 108: 55.74566490223377, 109: 26.742887764937905, 110: 0, 111: 0}"
473,9,13,65.32685323559207,4,7,20,0.09368883033524684,"[2, 4, 0]",122.17550032259912,4.522732188204701,13,work_charger,229,236,229,"{229: 122.17550032259912, 230: 117.65276813439442, 231: 104.08457156978031, 232: 81.47091062875681, 233: 49.8117853113239, 234: 9.107195617481594, 235: 0}"
473,5,15,64.09152333374278,8,12,24,0.07963550578495983,"[0, 2, 6]",64.65365507890733,4.606653658707032,15,work_charger,135,147,135,"{135: 64.65365507890733, 136: 60.0470014202003, 137: 46.22704044407921, 138: 23.19377215054405, 139: 0, 140: 0, 141: 0, 142: 0, 143: 0, 144: 0, 145: 0, 146: 0}"
474,10,9,26.52000436917317,3,5,14,0.13687008953573607,"[10, 4, 12]",57.92661776831737,3.6261217447527443,9,commuter,249,254,249,"{249: 57.92661776831737, 250: 54.30049602356463, 251: 43.422130789306394, 252: 25.291522065542672, 253: 0}"
474,0,9,30.24508769434271,4,7,16,0.13687008953573607,"[14, 12, 10]",128.68702691851252,3.421700183520228,9,commuter,9,16,9,"{9: 128.68702691851252, 10: 125.26532673499229, 11: 115.0002261844316, 12: 97.89172526683046, 13: 73.93982398218887, 14: 43.14452233050682, 15: 5.505820311784305}"
474,13,18,29.880760971382553,2,3,21,0.13960749132645078,"[10, 8, 4]",103.18571093571643,2.126076369865669,18,commuter,330,333,330,"{330: 103.18571093571643, 331: 101.05963456585076, 332: 94.68140545625376}"
474,1,8,24.76392412218373,2,3,11,0.13687008953573607,"[7, 6, 1]",62.56625496115058,1.5561366352735102,8,commuter,32,35,32,"{32: 62.56625496115058, 33: 61.010118325877066, 34: 56.341708420056534}"
475,5,10,20.17525285459114,3,7,17,0.06732189449050587,"[6, 12, 11]",91.18497923323227,3.940644489387022,10,weekend_user,130,137,130,"{130: 91.18497923323227, 131: 87.24433474384524, 132: 75.42240127568418, 133: 55.71917882874907, 134: 28.13466740303992, 135: 0, 136: 0}"
476,0,22,47.0892785001227,3,11,24,0.2748137659457137,"[7, 13, 1]",140.05106436374768,3.7853872579911414,22,night_charger,22,33,22,"{22: 140.05106436374768, 23: 136.26567710575654, 24: 124.90951533178313, 25: 105.98257904182742, 26: 79.48486823588942, 27: 45.416382913969144, 28: 3.7771230760666015, 29: 0, 30: 0, 31: 0, 32: 0}"
476,9,20,76.14546288368103,5,10,24,0.49466477870228476,"[4, 5, 9]",94.67506026907695,3.940468753666113,20,night_charger,236,246,236,"{236: 94.67506026907695, 237: 90.73459151541084, 238: 78.9131852544125, 239: 59.21084148608193, 240: 31.62756021041914, 241: 0, 242: 0, 243: 0, 244: 0, 245: 0}"
477,6,17,31.148846451466536,2,4,21,0.12693075030253276,"[0, 9, 8]",104.27446433562886,4.160036064113783,17,commuter,161,165,161,"{161: 104.27446433562886, 162: 100.11442827151508, 163: 87.63432007917373, 164: 66.83413975860482}"
477,2,18,44.08023268160248,3,5,23,0.149330294473568,"[9, 0, 2]",68.75731578187568,4.070476491306387,18,commuter,66,71,66,"{66: 68.75731578187568, 67: 64.68683929056928, 68: 52.47540981665013, 69: 32.12302736011819, 70: 3.6296919209734853}"
477,0,7,72.89923502358545,5,6,13,0.12444191206130663,"[3, 13, 9]",136.4405624341864,4.825924388924908,7,commuter,7,13,7,"{7: 136.4405624341864, 8: 131.6146380452615, 9: 117.13686487848678, 10: 93.00724293386223, 11: 59.22577221138788, 12: 15.792452711063703}"
477,7,17,48.04830624370359,3,6,23,0.149330294473568,"[9, 5, 4]",98.81452095272655,1.8646153104255188,17,commuter,185,191,185,"{185: 98.81452095272655, 186: 96.94990564230103, 187: 91.35605971102447, 188: 82.03298315889688, 189: 68.98067598591825, 190: 52.19913819208858}"
478,1,19,25.388997535937644,2,5,24,0.20916624246836962,"[9, 14, 4]",127.81794867157775,2.1736941996624064,19,commuter,43,48,43,"{43: 127.81794867157775, 44: 125.64425447191535, 45: 119.12317187292813, 46: 108.25470087461609, 47: 93.03884147697926}"
478,10,17,38.61590262972365,4,6,23,0.20916624246836962,"[9, 0, 4]",93.62692800425893,3.5225241886166527,17,commuter,257,263,257,"{257: 93.62692800425893, 258: 90.10440381564227, 259: 79.53683124979231, 260: 61.92421030670906, 261: 37.266540986392485, 262: 5.563823288842613}"
478,2,8,31.314067512696028,2,3,11,0.17430520205697467,"[1, 10, 4]",129.5383174122618,2.6086817081696423,8,commuter,56,59,56,"{56: 129.5383174122618, 57: 126.92963570409215, 58: 119.10359057958323}"
478,10,17,34.94320227091147,4,7,24,0.20916624246836962,"[2, 11, 14]",143.3273500457737,3.3853348338504783,17,commuter,257,264,257,"{257: 143.3273500457737, 258: 139.94201521192323, 259: 129.78601071037178, 260: 112.85933654111939, 261: 89.16199270416604, 262: 58.693979199511745, 263: 21.45529602715648}"
479,9,18,78.55501376424485,5,8,24,0.18635904715319934,"[10, 13, 6]",85.64781651478324,4.91924069555742,18,random,234,242,234,"{234: 85.64781651478324, 235: 80.72857581922582, 236: 65.97085373255356, 237: 41.374650254766465, 238: 6.939965385864525, 239: 0, 240: 0, 241: 0}"
479,9,20,56.74758563617982,7,10,24,0.18635904715319934,"[8, 10, 13]",83.03480119071625,4.399938141996834,20,random,236,246,236,"{236: 83.03480119071625, 237: 78.63486304871941, 238: 65.43504862272891, 239: 43.43535791274474, 240: 12.6357909187669, 241: 0, 242: 0, 243: 0, 244: 0, 245: 0}"
480,4,17,28.73066761925866,3,6,23,0.1840860455775546,"[6, 13, 3]",120.59757751249032,2.2094615695602675,17,commuter,113,119,113,"{113: 120.59757751249032, 114: 118.38811594293006, 115: 111.75973123424924, 116: 100.71242338644791, 117: 85.24619239952604, 118: 65.36103827348363}"
480,4,18,48.88915625029652,3,4,22,0.1840860455775546,"[11, 2, 10]",100.1893025160152,3.983867231544339,18,commuter,114,118,114,"{114: 100.1893025160152, 115: 96.20543528447087, 116: 84.25383358983785, 117: 64.33449743211615}"
480,4,9,45.20028384955913,4,7,16,0.15340503798129546,"[5, 7, 0]",65.74156844257337,1.4604478633281373,9,commuter,105,112,105,"{105: 65.74156844257337, 106: 64.28112057924523, 107: 59.899776989260815, 108: 52.597537672620135, 109: 42.37440262932317, 110: 29.23037185936994, 111: 13.165445362760423}"
481,13,18,30.288656870624543,3,4,22,0.13268222053491974,"[4, 13, 8]",135.67594515799968,3.0581036608768417,18,commuter,330,334,330,"{330: 135.67594515799968, 331: 132.61784149712284, 332: 123.44353051449231, 333: 108.1530122101081}"
481,9,9,69.58939202506689,5,6,15,0.13008060836756838,"[5, 13, 2]",55.69349569373134,2.929264417545287,9,commuter,225,231,225,"{225: 55.69349569373134, 226: 52.76423127618605, 227: 43.976438023550195, 228: 29.33011593582376, 229: 8.82526501300675, 230: 0}"
481,2,8,53.35108012456174,3,5,13,0.13008060836756838,"[5, 1, 9]",131.05885272216923,1.1445381592614408,8,commuter,56,61,56,"{56: 131.05885272216923, 57: 129.9143145629078, 58: 126.48070008512347, 59: 120.75800928881627, 60: 112.74624217398619}"
481,8,9,51.26914769748919,6,8,17,0.13008060836756838,"[14, 5, 11]",138.24511550400854,1.744842249886915,9,commuter,201,209,201,"{201: 138.24511550400854, 202: 136.50027325412162, 203: 131.26574650446088, 204: 122.5415352550263, 205: 110.3276395058179, 206: 94.62405925683566, 207: 75.4307945080796, 208: 52.747845259549706}"
482,7,20,45.1119021833304,3,9,24,0.2699700378508566,"[8, 3, 14]",92.18367323682938,1.3882773126197465,20,night_charger,188,197,188,"{188: 92.18367323682938, 189: 90.79539592420963, 190: 86.6305639863504, 191: 79.68917742325166, 192: 69.97123623491343, 193: 57.47674042133571, 194: 42.20568998251851, 195: 24.158084918461796, 196: 3.333925229165601}"
482,5,20,38.471300195055775,3,11,24,0.22947453217322805,"[14, 7, 12]",65.89054348754965,3.8047422617676063,20,night_charger,140,151,140,"{140: 65.89054348754965, 141: 62.08580122578204, 142: 50.671574440479226, 143: 31.647863131641195, 144: 5.014667299267948, 145: 0, 146: 0, 147: 0, 148: 0, 149: 0, 150: 0}"
483,9,12,54.540100872161304,4,6,18,0.09377480432719186,"[13, 8, 14]",117.93893186267032,4.9314129870482475,12,random,228,234,228,"{228: 117.93893186267032, 229: 113.00751887562207, 230: 98.21327991447733, 231: 73.55621497923609, 232: 39.036324069898356, 233: 0}"
483,1,14,5.0,1,4,18,0.09377480432719186,"[4, 3, 5]",95.23448529996449,4.403197513278455,14,random,38,42,38,"{38: 95.23448529996449, 39: 90.83128778668603, 40: 77.62169524685066, 41: 55.605707680458394}"
484,4,21,51.35454220533059,4,9,24,0.1160212000962578,"[9, 11, 1]",128.3480148508811,4.997106103784948,21,night_charger,117,126,117,"{117: 128.3480148508811, 118: 123.35090874709616, 119: 108.35959043574131, 120: 83.37405991681656, 121: 48.39431719032193, 122: 3.420362256257391, 123: 0, 124: 0, 125: 0}"
484,5,19,43.9505992141809,4,11,24,0.1775124361472744,"[10, 8, 11]",94.87638884268347,1.4850108485295626,19,night_charger,139,150,139,"{139: 94.87638884268347, 140: 93.3913779941539, 141: 88.93634544856522, 142: 81.5112912059174, 143: 71.11621526621047, 144: 57.7511176294444, 145: 41.41599829561922, 146: 22.110857264734904, 147: 0, 148: 0, 149: 0}"
484,0,23,46.722172493057954,3,11,24,0.08121484006738046,"[11, 6, 0]",96.98438202398472,2.1658065905816297,23,night_charger,23,34,23,"{23: 96.98438202398472, 24: 94.8185754334031, 25: 88.3211556616582, 26: 77.49212270875006, 27: 62.331476574678646, 28: 42.83921725944398, 29: 19.015344763046045, 30: 0, 31: 0, 32: 0, 33: 0}"
485,12,14,54.86608501303952,3,7,21,0.07543972388540782,"[5, 9, 2]",94.17224912169294,3.9490747610123393,14,weekend_user,302,309,302,"{302: 94.17224912169294, 303: 90.2231743606806, 304: 78.37595007764358, 305: 58.63057627258189, 306: 30.987052945495513, 307: 0, 308: 0}"
485,13,10,93.33371090156282,5,11,21,0.07543972388540782,"[5, 14, 8]",78.78402930768019,1.963197239752554,10,weekend_user,322,333,322,"{322: 78.78402930768019, 323: 76.82083206792763, 324: 70.93124034866997, 325: 61.1152541499072, 326: 47.37287347163932, 327: 29.70409831386634, 328: 8.10892867658825, 329: 0, 330: 0, 331: 0, 332: 0}"
486,6,21,29.741915629599927,3,5,24,0.06420524571674371,"[9, 1, 11]",114.18875771484792,4.855555472441953,21,random,165,170,165,"{165: 114.18875771484792, 166: 109.33320224240597, 167: 94.76653582508011, 168: 70.48875846287035, 169: 36.49987015577668}"
487,5,19,70.84162007496025,4,5,24,0.2865252507658769,"[10, 3, 1]",141.19757436817588,1.9322793347794045,19,random,139,144,139,"{139: 141.19757436817588, 140: 139.26529503339648, 141: 133.46845702905827, 142: 123.80706035516124, 143: 110.2811050117054}"
487,11,13,32.846230585450726,2,5,18,0.18727140572933132,"[10, 13, 3]",118.64123437411651,2.4102485689699407,13,random,277,282,277,"{277: 118.64123437411651, 278: 116.23098580514656, 279: 109.00024009823674, 280: 96.94899725338703, 281: 80.07725727059746}"
487,2,11,30.145694516191497,4,8,19,0.18727140572933132,"[12, 3, 4]",136.37039037779056,4.081283736130713,11,random,59,67,59,"{59: 136.37039037779056, 60: 132.28910664165986, 61: 120.0452554332677, 62: 99.63883675261414, 63: 71.06985059969915, 64: 34.338296974522734, 65: 0, 66: 0}"
488,13,10,31.433756626973548,4,5,15,0.06400689286978277,"[0, 4, 12]",96.57855731799725,1.8935761202128276,10,commuter,322,327,322,"{322: 96.57855731799725, 323: 94.68498119778442, 324: 89.00425283714594, 325: 79.5363722360818, 326: 66.28133939459201}"
488,10,17,28.601616039879254,2,3,20,0.13554400843012823,"[13, 1, 2]",113.58847682462078,4.400461063025393,17,commuter,257,260,257,"{257: 113.58847682462078, 258: 109.1880157615954, 259: 95.98663257251921}"
488,9,18,48.70037604746001,3,6,24,0.13554400843012823,"[9, 11, 7]",75.91201042714229,2.419020684519031,18,commuter,234,240,234,"{234: 75.91201042714229, 235: 73.49298974262327, 236: 66.23592768906617, 237: 54.140824266471014, 238: 37.207679474837796, 239: 15.436493314166519}"
488,8,9,16.70118941775973,1,2,11,0.11295334035844017,"[2, 1, 9]",104.50483963511391,3.687191586304248,9,commuter,201,203,201,"{201: 104.50483963511391, 202: 100.81764804880966}"
488,8,9,14.922838587424938,2,4,13,0.11295334035844017,"[11, 0, 5]",96.160321677132,3.784873590100121,9,commuter,201,205,201,"{201: 96.160321677132, 202: 92.37544808703188, 203: 81.02082731673153, 204: 62.09645936623092}"
489,4,21,49.174332050460634,3,9,24,0.23632533709238923,"[9, 0, 4]",76.68907461495627,1.9173425404056608,21,night_charger,117,126,117,"{117: 76.68907461495627, 118: 74.77173207455061, 119: 69.01970445333363, 120: 59.43299175130532, 121: 46.0115939684657, 122: 28.75551110481475, 123: 7.6647431603524865, 124: 0, 125: 0}"
489,9,19,37.6243823458913,4,9,24,0.42538560676630066,"[5, 2, 8]",83.57933376569747,2.4689833529984804,19,night_charger,235,244,235,"{235: 83.57933376569747, 236: 81.11035041269899, 237: 73.70340035370354, 238: 61.358483588711145, 239: 44.075600117721784, 240: 21.85474994073546, 241: 0, 242: 0, 243: 0}"
490,13,13,12.325084888831643,2,5,18,0.25323931725265386,"[2, 10, 6]",131.91251017427464,1.047919318664285,13,commuter,325,330,325,"{325: 131.91251017427464, 326: 130.86459085561034, 327: 127.7208328996175, 328: 122.48123630629608, 329: 115.14580107564609}"
490,1,7,42.33472258047611,4,6,13,0.4468929127988009,"[1, 6, 2]",135.36044060133682,3.8120644901496923,7,commuter,31,37,31,"{31: 135.36044060133682, 32: 131.54837611118714, 33: 120.11218264073806, 34: 101.05186018998958, 35: 74.36740875894174, 36: 40.05882834759451}"
490,7,18,36.49042609517303,3,6,24,0.5362714953585611,"[8, 0, 11]",69.7192692372041,1.5183381484990517,18,commuter,186,192,186,"{186: 69.7192692372041, 187: 68.20093108870505, 188: 63.6459166432079, 189: 56.05422590071264, 190: 45.425858861219275, 191: 31.76081552472781}"
490,8,9,14.097360326942574,1,3,12,0.4468929127988009,"[10, 2, 9]",78.99954031733017,1.380839812604783,9,commuter,201,204,201,"{201: 78.99954031733017, 202: 77.6187005047254, 203: 73.47618106691104}"
491,12,16,49.07631871965271,4,7,23,0.22516838452060675,"[0, 11, 1]",62.74155188015534,4.570335105558481,16,weekend_user,304,311,304,"{304: 62.74155188015534, 305: 58.17121677459686, 306: 44.46021145792142, 307: 21.60853593012901, 308: 0, 309: 0, 310: 0}"
492,6,18,29.474659674687242,2,7,24,0.2266278081997764,"[8, 4, 10]",61.541423909131794,1.5089726909721324,18,work_charger,162,169,162,"{162: 61.541423909131794, 163: 60.032451218159665, 164: 55.50553314524326, 165: 47.9606696903826, 166: 37.397860853577676, 167: 23.817106634828484, 168: 7.218407034135026}"
492,4,10,63.96966024753905,6,9,19,0.14812275045737022,"[11, 7, 14]",95.62561011419731,1.4498026929341328,10,work_charger,106,115,106,"{106: 95.62561011419731, 107: 94.17580742126319, 108: 89.82639934246079, 109: 82.57738587779012, 110: 72.42876702725118, 111: 59.380542790844, 112: 43.43271316856853, 113: 24.585278160424807, 114: 2.838237766412817}"
492,9,12,52.75293053323973,4,8,20,0.14812275045737022,"[5, 8, 9]",74.00958962784875,3.2274350229490474,12,work_charger,228,236,228,"{228: 74.00958962784875, 229: 70.7821546048997, 230: 61.09984953605257, 231: 44.96267442130733, 232: 22.370629260663996, 233: 0, 234: 0, 235: 0}"
492,4,8,56.706561405639206,3,6,14,0.2221841256860553,"[11, 13, 3]",57.357963815975154,1.4775340154346934,8,work_charger,104,110,104,"{104: 57.357963815975154, 105: 55.88042980054046, 106: 51.44782775423638, 107: 44.06015767706291, 108: 33.71741956902006, 109: 20.419613430107816}"
493,12,16,42.917211737772746,3,6,22,0.08796989314957869,"[6, 14, 1]",142.68722028146584,1.7246104292198847,16,random,304,310,304,"{304: 142.68722028146584, 305: 140.96260985224595, 306: 135.7887785645863, 307: 127.16572641848688, 308: 115.09345341394769, 309: 99.57195955096873}"
494,12,13,21.217317237401776,4,7,20,0.21125209467828446,"[5, 11, 6]",124.81025653169485,4.35974912207871,13,commuter,301,308,301,"{301: 124.81025653169485, 302: 120.45050740961614, 303: 107.37126004338, 304: 85.57251443298645, 305: 55.05427057843549, 306: 15.816528479727111, 307: 0}"
494,10,17,34.16543657467306,2,3,20,0.4473573769657789,"[0, 2, 1]",67.17655901154788,1.040850998451373,17,commuter,257,260,257,"{257: 67.17655901154788, 258: 66.1357080130965, 259: 63.01315501774239}"
494,11,17,13.636202796447273,1,2,19,0.4473573769657789,"[8, 7, 9]",78.70566061191558,3.6517970937184447,17,commuter,281,283,281,"{281: 78.70566061191558, 282: 75.05386351819713}"
494,13,11,10.343182982641157,1,3,14,0.21125209467828446,"[10, 2, 11]",84.58112770338225,3.0130323331614215,11,commuter,323,326,323,"{323: 84.58112770338225, 324: 81.56809537022083, 325: 72.52899837073656}"
494,2,18,23.40789440219301,3,6,24,0.4473573769657789,"[13, 9, 14]",59.237083927589666,1.2430149183520802,18,commuter,66,72,66,"{66: 59.237083927589666, 67: 57.994069009237585, 68: 54.26502425418134, 69: 48.04994966242094, 70: 39.34884523395638, 71: 28.16171096878766}"
495,2,11,33.948284891608736,2,6,17,0.2949859922374861,"[1, 4, 6]",54.36033835862126,4.6195708019916655,11,work_charger,59,65,59,"{59: 54.36033835862126, 60: 49.7407675566296, 61: 35.8820551506546, 62: 12.784201140696275, 63: 0, 64: 0}"
495,6,11,41.625799004592864,6,10,21,0.2507380934018632,"[13, 9, 7]",143.71949271186537,1.3892073951916033,11,work_charger,155,165,155,"{155: 143.71949271186537, 156: 142.33028531667378, 157: 138.16266313109895, 158: 131.21662615514094, 159: 121.49217438879973, 160: 108.9893078320753, 161: 93.70802648496766, 162: 75.64833034747681, 163: 54.81021941960276, 164: 31.19369370134551}"
495,1,11,53.19592447589115,5,9,20,0.2949859922374861,"[6, 4, 8]",141.05522508215967,1.413833134819812,11,work_charger,35,44,35,"{35: 141.05522508215967, 36: 139.64139194733986, 37: 135.39989254288042, 38: 128.33072686878137, 39: 118.43389492504267, 40: 105.70939671166437, 41: 90.15723222864642, 42: 71.77740147598887, 43: 50.56990445369169}"
496,9,11,53.59761798597945,7,11,22,0.07871385578511317,"[11, 8, 2]",95.08742314022399,3.7735289767779094,11,work_charger,227,238,227,"{227: 95.08742314022399, 228: 91.31389416344608, 229: 79.99330723311235, 230: 61.12566234922281, 231: 34.71095951177744, 232: 0.7491987207762492, 233: 0, 234: 0, 235: 0, 236: 0, 237: 0}"
496,13,16,30.580814274577207,2,6,22,0.0669067774173462,"[9, 4, 10]",75.22520509072021,1.4493489281761622,16,work_charger,328,334,328,"{328: 75.22520509072021, 329: 73.77585616254404, 330: 69.42780937801555, 331: 62.18106473713475, 332: 52.03562223990161, 333: 38.99148188631615}"
496,6,17,54.52576691982513,4,8,24,0.12043219935122314,"[3, 12, 0]",145.30005982995715,1.4055795353320537,17,work_charger,161,169,161,"{161: 145.30005982995715, 162: 143.89448029462508, 163: 139.67774168862894, 164: 132.64984401196867, 165: 122.81078726464429, 166: 110.16057144665581, 167: 94.69919655800322, 168: 76.42666259868652}"
496,11,13,20.66584991660638,2,6,19,0.07871385578511317,"[3, 12, 2]",122.12412749928592,2.7831666041120253,13,work_charger,277,283,277,"{277: 122.12412749928592, 278: 119.3409608951739, 279: 110.99146108283782, 280: 97.07562806227769, 281: 77.5934618334935, 282: 52.54496239648529}"
497,7,17,12.66537622964655,2,3,20,0.15580908608235794,"[3, 12, 5]",148.56598475582382,2.4726229614511515,17,commuter,185,188,185,"{185: 148.56598475582382, 186: 146.09336179437267, 187: 138.67549291001922}"
497,2,9,28.087083949705274,2,5,14,0.12984090506863158,"[3, 13, 0]",108.38622812910351,4.4830558444886,9,commuter,57,62,57,"{57: 108.38622812910351, 58: 103.90317228461491, 59: 90.45400475114911, 60: 68.03872552870611, 61: 36.65733461728591}"
497,2,9,28.88195691062839,2,3,12,0.12984090506863158,"[2, 5, 0]",114.50246416097401,4.222150552326058,9,commuter,57,60,57,"{57: 114.50246416097401, 58: 110.28031360864796, 59: 97.61386195166978}"
498,7,7,54.077340663940326,3,6,13,0.1312891318530867,"[14, 0, 9]",97.49022918309626,2.3879572745944424,7,commuter,175,181,175,"{175: 97.49022918309626, 176: 95.10227190850182, 177: 87.9384000847185, 178: 75.99861371174629, 179: 59.28291278958518, 180: 37.7912973182352}"
498,4,7,49.2631982131456,4,6,13,0.1312891318530867,"[7, 8, 3]",99.28482809843965,4.4945108856011675,7,commuter,103,109,103,"{103: 99.28482809843965, 104: 94.79031721283847, 105: 81.30678455603498, 106: 58.83423012802914, 107: 27.372653928820966, 108: 0}"
498,5,19,17.009484232743034,2,4,23,0.13391491449014845,"[5, 9, 3]",117.46443700858022,1.1428057154286533,19,commuter,139,143,139,"{139: 117.46443700858022, 140: 116.32163129315157, 141: 112.8932141468656, 142: 107.17918556972234}"
498,10,8,44.424992532750586,3,5,13,0.1312891318530867,"[13, 0, 4]",71.96876254294817,4.799864352362949,8,commuter,248,253,248,"{248: 71.96876254294817, 249: 67.16889819058522, 250: 52.769305133496374, 251: 28.769983371681633, 252: 0}"
498,7,17,62.51259050879761,5,7,24,0.15754695822370407,"[0, 7, 9]",71.7583713867956,3.9034855444597936,17,commuter,185,192,185,"{185: 71.7583713867956, 186: 67.8548858423358, 187: 56.144429208956424, 188: 36.62700148665746, 189: 9.302602675438905, 190: 0, 191: 0}"
499,2,8,30.501202453089192,2,4,12,0.12317722255372579,"[14, 13, 12]",68.46980544113715,1.6311039911697809,8,work_charger,56,60,56,"{56: 68.46980544113715, 57: 66.83870144996737, 58: 61.94538947645803, 59: 53.78986952060913}"
499,1,12,69.20220663685286,4,6,18,0.08211814836915053,"[4, 1, 7]",112.31148401627746,4.530211453940405,12,work_charger,36,42,36,"{36: 112.31148401627746, 37: 107.78127256233705, 38: 94.19063820051585, 39: 71.53958093081383, 40: 39.828100753230984, 41: 0}"
499,10,10,69.29729433928836,4,8,18,0.08211814836915053,"[11, 7, 14]",127.6582461044869,4.875811954613171,10,work_charger,250,258,250,"{250: 127.6582461044869, 251: 122.78243414987374, 252: 108.15499828603421, 253: 83.77593851296837, 254: 49.645254830676166, 255: 5.762947239157626, 256: 0, 257: 0}"
499,5,18,40.02941078463189,4,6,24,0.1256407670048003,"[2, 7, 5]",99.10472124280867,4.7985448144878635,18,work_charger,138,144,138,"{138: 99.10472124280867, 139: 94.3061764283208, 140: 79.91054198485722, 141: 55.917817912417895, 142: 22.32800421100285, 143: 0}"
